"ID";"Airports";"Periods";"TotalFlights_3";"TotalArrivalsFlights_6";"TotalDeparturesFlights_9";"TotalPassengers_12";"TotalArrivalsPassengers_15";"TotalDeparturesPassengers_18";"TotalCountryOfOriginDestination_21";"EuropeTotal_22";"EUCountries_23";"TotalIntercontinentalPassengers_25";"America_32";"Asia_36";"WestAsia_37";"SouthEastAsia_38";"NorthEastAsia_39"
"0";"A045844";"1997JJ00";"  400118";"  200040";"  200078";"32074513";"16013919";"16060594";"32074513";"21239558";"17658777";"10751804";" 6038044";" 3379017";" 1103362";" 1252522";" 1023133"
"1";"A045844";"1998JJ00";"  425608";"  212751";"  212857";"35129029";"17484447";"17644582";"35129029";"23548703";"19613702";"11466164";" 6367845";" 3680895";" 1223619";" 1346148";" 1111128"
"2";"A045844";"1999MM01";"   33145";"   16565";"   16580";" 2439980";" 1226117";" 1213863";" 2439980";" 1559839";" 1317817";"  876945";"  455002";"  298997";"   88737";"  129031";"   81229"
"3";"A045844";"1999MM02";"   30912";"   15444";"   15468";" 2405830";" 1194375";" 1211455";" 2405830";" 1604074";" 1365968";"  798996";"  408987";"  274295";"   82654";"  110775";"   80866"
"4";"A045844";"1999MM03";"   35591";"   17802";"   17789";" 2905023";" 1457675";" 1447348";" 2905023";" 1911957";" 1630143";"  989194";"  531834";"  330139";"  105905";"  120094";"  104140"
"5";"A045844";"1999KW01";"   99648";"   49811";"   49837";" 7750833";" 3878167";" 3872666";" 7750833";" 5075870";" 4313928";" 2665135";" 1395823";"  903431";"  277296";"  359900";"  266235"
"6";"A045844";"1999MM04";"   35832";"   17910";"   17922";" 2983754";" 1468181";" 1515573";" 2983754";" 2003716";" 1707582";"  975511";"  524706";"  331128";"  114182";"  109316";"  107630"
"7";"A045844";"1999MM05";"   38376";"   19200";"   19176";" 3399339";" 1701169";" 1698170";" 3399339";" 2354180";" 1996034";" 1033553";"  588521";"  326257";"  112851";"  105889";"  107517"
"8";"A045844";"1999MM06";"   37971";"   18991";"   18980";" 3357773";" 1657203";" 1700570";" 3357773";" 2297541";" 1928122";" 1047597";"  614953";"  314288";"  106125";"  101899";"  106264"
"9";"A045844";"1999KW02";"  112179";"   56101";"   56078";" 9740866";" 4826553";" 4914313";" 9740866";" 6655437";" 5631738";" 3056661";" 1728180";"  971673";"  333158";"  317104";"  321411"
"10";"A045844";"1999MM07";"   39824";"   19904";"   19920";" 3753435";" 1756699";" 1996736";" 3753435";" 2548119";" 2084124";" 1194156";"  670512";"  365967";"  128138";"  116167";"  121662"
"11";"A045844";"1999MM08";"   39908";"   19961";"   19947";" 3850371";" 2014765";" 1835606";" 3850371";" 2584440";" 2106132";" 1253165";"  692770";"  395456";"  150219";"  123020";"  122217"
"12";"A045844";"1999MM09";"   38969";"   19478";"   19491";" 3610066";" 1812291";" 1797775";" 3610066";" 2468932";" 2081781";" 1127952";"  634140";"  350160";"  121234";"  111050";"  117876"
"13";"A045844";"1999KW03";"  118701";"   59343";"   59358";"11213872";" 5583755";" 5630117";"11213872";" 7601491";" 6272037";" 3575273";" 1997422";" 1111583";"  399591";"  350237";"  361755"
"14";"A045844";"1999MM10";"   39553";"   19779";"   19774";" 3577374";" 1806100";" 1771274";" 3577374";" 2417121";" 2026668";" 1150268";"  628633";"  374954";"  134680";"  122041";"  118233"
"15";"A045844";"1999MM11";"   37387";"   18704";"   18683";" 2889913";" 1459437";" 1430476";" 2889913";" 1902396";" 1614143";"  984978";"  515870";"  335969";"  105347";"  132419";"   98203"
"16";"A045844";"1999MM12";"   35119";"   17592";"   17527";" 2531172";" 1264854";" 1266318";" 2531172";" 1649564";" 1386383";"  879668";"  464360";"  295176";"   92084";"  119712";"   83380"
"17";"A045844";"1999KW04";"  112059";"   56075";"   55984";" 8998459";" 4530391";" 4468068";" 8998459";" 5969081";" 5027194";" 3014914";" 1608863";" 1006099";"  332111";"  374172";"  299816"
"18";"A045844";"1999JJ00";"  442587";"  221330";"  221257";"37704030";"18818866";"18885164";"37704030";"25301879";"21244897";"12311983";" 6730288";" 3992786";" 1342156";" 1401413";" 1249217"
"19";"A045844";"2000MM01";"   36446";"   18182";"   18264";" 2563382";" 1278929";" 1284453";" 2563382";" 1653050";" 1385710";"  910332";"  468432";"  314652";"   91217";"  135072";"   88363"
"20";"A045844";"2000MM02";"   36041";"   18024";"   18017";" 2641094";" 1289485";" 1351609";" 2641094";" 1753422";" 1487079";"  887672";"  444379";"  314562";"   91972";"  130297";"   92293"
"21";"A045844";"2000MM03";"   38790";"   19396";"   19394";" 3162563";" 1603733";" 1558830";" 3162563";" 2110583";" 1777349";" 1051978";"  555392";"  354650";"  114210";"  132135";"  108305"
"22";"A045844";"2000KW01";"  111277";"   55602";"   55675";" 8367039";" 4172147";" 4194892";" 8367039";" 5517055";" 4650138";" 2849982";" 1468203";"  983864";"  297399";"  397504";"  288961"
"23";"A045844";"2000MM04";"   38281";"   19143";"   19138";" 3326762";" 1628248";" 1698514";" 3326762";" 2241068";" 1870313";" 1085690";"  575714";"  371650";"  129864";"  124354";"  117432"
"24";"A045844";"2000MM05";"   41972";"   20995";"   20977";" 3706883";" 1845433";" 1861450";" 3706883";" 2602356";" 2154141";" 1104523";"  623217";"  355707";"  122601";"  113051";"  120055"
"25";"A045844";"2000MM06";"   40483";"   20248";"   20235";" 3661177";" 1829019";" 1832158";" 3661177";" 2540998";" 2065738";" 1120179";"  655471";"  339040";"  110585";"  110128";"  118327"
"26";"A045844";"2000KW02";"  120736";"   60386";"   60350";"10694822";" 5302700";" 5392122";"10694822";" 7384422";" 6090192";" 3310392";" 1854402";" 1066397";"  363050";"  347533";"  355814"
"27";"A045844";"2000MM07";"   42092";"   21045";"   21047";" 4121196";" 1929467";" 2191729";" 4121196";" 2837159";" 2269163";" 1284037";"  714381";"  403142";"  141439";"  125555";"  136148"
"28";"A045844";"2000MM08";"   42255";"   21124";"   21131";" 4096727";" 2150204";" 1946523";" 4096727";" 2807034";" 2240136";" 1289693";"  702802";"  409908";"  150100";"  127893";"  131915"
"29";"A045844";"2000MM09";"   40476";"   20245";"   20231";" 3897872";" 1943139";" 1954733";" 3897872";" 2709597";" 2218964";" 1188275";"  651033";"  380468";"  126223";"  121304";"  132941"
"30";"A045844";"2000KW03";"  124823";"   62414";"   62409";"12115795";" 6022810";" 6092985";"12115795";" 8353790";" 6728263";" 3762005";" 2068216";" 1193518";"  417762";"  374752";"  401004"
"31";"A045844";"2000MM10";"   41254";"   20624";"   20630";" 3803796";" 1938661";" 1865135";" 3803796";" 2627702";" 2150564";" 1176094";"  620993";"  394934";"  129359";"  132597";"  132978"
"32";"A045844";"2000MM11";"   37280";"   18640";"   18640";" 3004146";" 1511732";" 1492414";" 3004146";" 1990482";" 1668669";" 1013657";"  521696";"  348726";"   96316";"  142380";"  110030"
"33";"A045844";"2000MM12";"   35192";"   17601";"   17591";" 2783392";" 1360805";" 1422587";" 2783392";" 1801015";" 1499677";"  982377";"  505127";"  338342";"   92897";"  140959";"  104486"
"34";"A045844";"2000KW04";"  113726";"   56865";"   56861";" 9591334";" 4811198";" 4780136";" 9591334";" 6419199";" 5318910";" 3172128";" 1647816";" 1082002";"  318572";"  415936";"  347494"
"35";"A045844";"2000JJ00";"  470562";"  235267";"  235295";"40768990";"20308855";"20460135";"40768990";"27674466";"22787503";"13094507";" 7038637";" 4325781";" 1396783";" 1535725";" 1393273"
"36";"A045844";"2001MM01";"   37077";"   18535";"   18542";" 2780249";" 1410283";" 1369966";" 2780249";" 1782728";" 1493138";"  997521";"  495888";"  353274";"   93247";"  156379";"  103648"
"37";"A045844";"2001MM02";"   34265";"   17132";"   17133";" 2667331";" 1304053";" 1363278";" 2667331";" 1774056";" 1491643";"  893273";"  432925";"  324347";"   88845";"  139103";"   96399"
"38";"A045844";"2001MM03";"   38876";"   19427";"   19449";" 3255834";" 1651160";" 1604674";" 3255834";" 2170145";" 1798844";" 1085687";"  554418";"  380875";"  118069";"  144062";"  118744"
"39";"A045844";"2001KW01";"  110218";"   55094";"   55124";" 8703414";" 4365496";" 4337918";" 8703414";" 5726929";" 4783625";" 2976481";" 1483231";" 1058496";"  300161";"  439544";"  318791"
"40";"A045844";"2001MM04";"   37447";"   18730";"   18717";" 3457934";" 1698837";" 1759097";" 3457934";" 2346581";" 1942338";" 1111353";"  598527";"  376383";"  126168";"  135299";"  114916"
"41";"A045844";"2001MM05";"   41159";"   20572";"   20587";" 3782078";" 1880738";" 1901340";" 3782078";" 2684492";" 2164005";" 1097560";"  618800";"  355295";"  118287";"  122319";"  114689"
"42";"A045844";"2001MM06";"   40153";"   20065";"   20088";" 3841225";" 1912937";" 1928288";" 3841225";" 2672823";" 2156624";" 1168402";"  660362";"  370778";"  120702";"  125574";"  124502"
"43";"A045844";"2001KW02";"  118759";"   59367";"   59392";"11081237";" 5492512";" 5588725";"11081237";" 7703896";" 6262967";" 3377315";" 1877689";" 1102456";"  365157";"  383192";"  354107"
"44";"A045844";"2001MM07";"   42528";"   21266";"   21262";" 4278757";" 2011002";" 2267755";" 4278757";" 2977031";" 2347017";" 1301724";"  691964";"  440309";"  161274";"  145447";"  133588"
"45";"A045844";"2001MM08";"   42681";"   21336";"   21345";" 4246834";" 2235051";" 2011783";" 4246834";" 2922400";" 2321448";" 1324434";"  689852";"  455281";"  176329";"  144805";"  134147"
"46";"A045844";"2001MM09";"   40643";"   20333";"   20310";" 3719690";" 1857773";" 1861917";" 3719690";" 2658705";" 2131604";" 1060795";"  537573";"  373557";"  121659";"  126840";"  125058"
"47";"A045844";"2001KW03";"  125852";"   62935";"   62917";"12245281";" 6103826";" 6141455";"12245281";" 8558136";" 6800069";" 3686953";" 1919389";" 1269147";"  459262";"  417092";"  392793"
"48";"A045844";"2001MM10";"   40724";"   20370";"   20354";" 3376995";" 1724265";" 1652730";" 3376995";" 2440605";" 1966279";"  936390";"  465976";"  326378";"  102672";"  119984";"  103722"
"49";"A045844";"2001MM11";"   34054";"   17027";"   17027";" 2730083";" 1370081";" 1360002";" 2730083";" 1903957";" 1607316";"  826126";"  419974";"  286355";"   75966";"  121009";"   89380"
"50";"A045844";"2001MM12";"   32587";"   16297";"   16290";" 2652554";" 1292913";" 1359641";" 2652554";" 1764491";" 1475242";"  888063";"  453844";"  306971";"   88133";"  125785";"   93053"
"51";"A045844";"2001KW04";"  107365";"   53694";"   53671";" 8759632";" 4387259";" 4372373";" 8759632";" 6109053";" 5048837";" 2650579";" 1339794";"  919704";"  266771";"  366778";"  286155"
"52";"A045844";"2001JJ00";"  462194";"  231090";"  231104";"40789564";"20349093";"20440471";"40789564";"28098014";"22895498";"12691328";" 6620103";" 4349803";" 1391351";" 1606606";" 1351846"
"53";"A045844";"2002MM01";"   33955";"   16966";"   16989";" 2636649";" 1336776";" 1299873";" 2636649";" 1721082";" 1447678";"  915567";"  448415";"  326813";"   86132";"  140592";"  100089"
"54";"A045844";"2002MM02";"   31396";"   15704";"   15692";" 2667372";" 1312182";" 1355190";" 2667372";" 1823929";" 1541035";"  843403";"  402249";"  304078";"   84208";"  126986";"   92884"
"55";"A045844";"2002MM03";"   35638";"   17810";"   17828";" 3249398";" 1634148";" 1615250";" 3249398";" 2210536";" 1844104";" 1038855";"  518028";"  362137";"  107118";"  136231";"  118788"
"56";"A045844";"2002KW01";"  100989";"   50480";"   50509";" 8553419";" 4283106";" 4270313";" 8553419";" 5755547";" 4832817";" 2797825";" 1368692";"  993028";"  277458";"  403809";"  311761"
"57";"A045844";"2002MM04";"   36474";"   18237";"   18237";" 3411882";" 1650092";" 1761790";" 3411882";" 2419921";" 1975597";"  991957";"  507066";"  347607";"  107360";"  123931";"  116316"
"58";"A045844";"2002MM05";"   39387";"   19690";"   19697";" 3863240";" 1953393";" 1909847";" 3863240";" 2823330";" 2234872";" 1039910";"  563303";"  348078";"  109347";"  120597";"  118134"
"59";"A045844";"2002MM06";"   38233";"   19110";"   19123";" 3814245";" 1878689";" 1935556";" 3814245";" 2706002";" 2150273";" 1108231";"  608650";"  359917";"  116337";"  118960";"  124620"
"60";"A045844";"2002KW02";"  114094";"   57037";"   57057";"11089367";" 5482174";" 5607193";"11089367";" 7949253";" 6360742";" 3140098";" 1679019";" 1055602";"  333044";"  363488";"  359070"
"61";"A045844";"2002MM07";"   40619";"   20303";"   20316";" 4289281";" 2034750";" 2254531";" 4289281";" 3052847";" 2362679";" 1236434";"  656689";"  406728";"  147451";"  132312";"  126965"
"62";"A045844";"2002MM08";"   40340";"   20168";"   20172";" 4276395";" 2238757";" 2037638";" 4276395";" 3003393";" 2343437";" 1273002";"  665832";"  427248";"  162856";"  132314";"  132078"
"63";"A045844";"2002MM09";"   38856";"   19428";"   19428";" 4020765";" 1996530";" 2024235";" 4020765";" 2872676";" 2284710";" 1148089";"  605020";"  380326";"  124275";"  125131";"  130920"
"64";"A045844";"2002KW03";"  119815";"   59899";"   59916";"12586441";" 6270037";" 6316404";"12586441";" 8928916";" 6990826";" 3657525";" 1927541";" 1214302";"  434582";"  389757";"  389963"
"65";"A045844";"2002MM10";"   39325";"   19659";"   19666";" 3862884";" 1964088";" 1898796";" 3862884";" 2741612";" 2149145";" 1121272";"  584454";"  368414";"  114685";"  129357";"  124372"
"66";"A045844";"2002MM11";"   34675";"   17346";"   17329";" 2977998";" 1496868";" 1481130";" 2977998";" 2017447";" 1681687";"  960551";"  493734";"  323831";"   88803";"  125175";"  109853"
"67";"A045844";"2002MM12";"   32695";"   16349";"   16346";" 2912646";" 1418289";" 1494357";" 2912646";" 1905645";" 1582237";" 1006987";"  528920";"  330373";"  101238";"  126132";"  103003"
"68";"A045844";"2002KW04";"  106695";"   53354";"   53341";" 9753528";" 4879245";" 4874283";" 9753528";" 6664704";" 5413069";" 3088810";" 1607108";" 1022618";"  304726";"  380664";"  337228"
"69";"A045844";"2002JJ00";"  441593";"  220770";"  220823";"41982755";"20914562";"21068193";"41982755";"29298420";"23597454";"12684258";" 6582360";" 4285550";" 1349810";" 1537718";" 1398022"
"70";"A045844";"2003MM01";"   32975";"   16463";"   16512";" 2813139";" 1427419";" 1385720";" 2813139";" 1820298";" 1519721";"  992841";"  497324";"  344905";"   97017";"  141969";"  105919"
"71";"A045844";"2003MM02";"   31210";"   15601";"   15609";" 2741087";" 1346064";" 1395023";" 2741087";" 1866580";" 1568201";"  874507";"  430647";"  301449";"   78301";"  125163";"   97985"
"72";"A045844";"2003MM03";"   35283";"   17641";"   17642";" 3099952";" 1576809";" 1523143";" 3099952";" 2152637";" 1793207";"  947315";"  502727";"  304356";"   72245";"  123682";"  108429"
"73";"A045844";"2003KW01";"   99468";"   49705";"   49763";" 8654178";" 4350292";" 4303886";" 8654178";" 5839515";" 4881129";" 2814663";" 1430698";"  950710";"  247563";"  390814";"  312333"
"74";"A045844";"2003MM04";"   34247";"   17128";"   17119";" 3108279";" 1496581";" 1611698";" 3108279";" 2251494";" 1856104";"  856785";"  482273";"  251322";"   67458";"  107236";"   76628"
"75";"A045844";"2003MM05";"   37126";"   18547";"   18579";" 3553181";" 1782708";" 1770473";" 3553181";" 2650000";" 2117195";"  903181";"  532927";"  250710";"   91225";"   98317";"   61168"
"76";"A045844";"2003MM06";"   36582";"   18299";"   18283";" 3695057";" 1822519";" 1872538";" 3695057";" 2699580";" 2134195";"  995477";"  582663";"  287188";"  102463";"  108755";"   75970"
"77";"A045844";"2003KW02";"  107955";"   53974";"   53981";"10356517";" 5101808";" 5254709";"10356517";" 7601074";" 6107494";" 2755443";" 1597863";"  789220";"  261146";"  314308";"  213766"
"78";"A045844";"2003MM07";"   39230";"   19616";"   19614";" 4244484";" 2010027";" 2234457";" 4244484";" 3052051";" 2322806";" 1192433";"  656404";"  370119";"  135418";"  135619";"   99082"
"79";"A045844";"2003MM08";"   38672";"   19337";"   19335";" 4194993";" 2221070";" 1973923";" 4194993";" 2956211";" 2267858";" 1238782";"  651163";"  411572";"  150506";"  135336";"  125730"
"80";"A045844";"2003MM09";"   37886";"   18935";"   18951";" 3898022";" 1931401";" 1966621";" 3898022";" 2791710";" 2187147";" 1106312";"  585691";"  364218";"  115434";"  118291";"  130493"
"81";"A045844";"2003KW03";"  115788";"   57888";"   57900";"12337499";" 6162498";" 6175001";"12337499";" 8799972";" 6777811";" 3537527";" 1893258";" 1145909";"  401358";"  389246";"  355305"
"82";"A045844";"2003MM10";"   38118";"   19060";"   19058";" 3915075";" 1989708";" 1925367";" 3915075";" 2785110";" 2156105";" 1129965";"  583304";"  377910";"  119958";"  127331";"  130621"
"83";"A045844";"2003MM11";"   33627";"   16821";"   16806";" 3067998";" 1538955";" 1529043";" 3067998";" 2078860";" 1699534";"  989138";"  510367";"  330588";"   91866";"  127464";"  111258"
"84";"A045844";"2003MM12";"   31880";"   15973";"   15907";" 2932855";" 1431518";" 1501337";" 2932855";" 1920118";" 1569362";" 1012737";"  524144";"  334043";"  102219";"  131792";"  100032"
"85";"A045844";"2003KW04";"  103625";"   51854";"   51771";" 9915928";" 4960181";" 4955747";" 9915928";" 6784088";" 5425001";" 3131840";" 1617815";" 1042541";"  314043";"  386587";"  341911"
"86";"A045844";"2003JJ00";"  426836";"  213421";"  213415";"41264122";"20574779";"20689343";"41264122";"29024649";"23191435";"12239473";" 6539634";" 3928380";" 1224110";" 1480955";" 1223315"
"87";"A045844";"2004MM01";"   32016";"   15961";"   16055";" 2818427";" 1424496";" 1393931";" 2818427";" 1788792";" 1465324";" 1029635";"  511108";"  350952";"  100198";"  146496";"  104258"
"88";"A045844";"2004MM02";"   31900";"   15942";"   15958";" 2922639";" 1439234";" 1483405";" 2922639";" 1963539";" 1617410";"  959100";"  461663";"  333041";"   93775";"  133151";"  106115"
"89";"A045844";"2004MM03";"   35825";"   17906";"   17919";" 3382340";" 1718281";" 1664059";" 3382340";" 2297388";" 1881689";" 1084952";"  552050";"  363591";"  108120";"  134139";"  121332"
"90";"A045844";"2004KW01";"   99741";"   49809";"   49932";" 9123406";" 4582011";" 4541395";" 9123406";" 6049719";" 4964423";" 3073687";" 1524821";" 1047584";"  302093";"  413786";"  331705"
"91";"A045844";"2004MM04";"   35818";"   17902";"   17916";" 3657936";" 1773840";" 1884096";" 3657936";" 2558114";" 2033902";" 1099822";"  580744";"  369215";"  119625";"  123333";"  126257"
"92";"A045844";"2004MM05";"   39208";"   19600";"   19608";" 4076485";" 2049899";" 2026586";" 4076485";" 2963055";" 2248244";" 1113430";"  615433";"  360457";"  114456";"  118529";"  127472"
"93";"A045844";"2004MM06";"   38581";"   19283";"   19298";" 4008925";" 2001351";" 2007574";" 4008925";" 2874955";" 2226323";" 1133970";"  623784";"  374018";"  118316";"  121015";"  134687"
"94";"A045844";"2004KW02";"  113607";"   56785";"   56822";"11743346";" 5825090";" 5918256";"11743346";" 8396124";" 6508469";" 3347222";" 1819961";" 1103690";"  352397";"  362877";"  388416"
"95";"A045844";"2004MM07";"   40367";"   20170";"   20197";" 4565684";" 2137750";" 2427934";" 4565684";" 3267379";" 2412979";" 1298305";"  679539";"  431727";"  141364";"  143510";"  146853"
"96";"A045844";"2004MM08";"   40033";"   20023";"   20010";" 4483625";" 2350963";" 2132662";" 4483625";" 3175082";" 2381487";" 1308543";"  677812";"  438630";"  150597";"  141111";"  146922"
"97";"A045844";"2004MM09";"   38946";"   19482";"   19464";" 4153659";" 2067063";" 2086596";" 4153659";" 2957388";" 2275829";" 1196271";"  624868";"  393976";"  118201";"  124670";"  151105"
"98";"A045844";"2004KW03";"  119346";"   59675";"   59671";"13202968";" 6555776";" 6647192";"13202968";" 9399849";" 7070295";" 3803119";" 1982219";" 1264333";"  410162";"  409291";"  444880"
"99";"A045844";"2004MM10";"   40144";"   20076";"   20068";" 4155554";" 2105582";" 2049972";" 4155554";" 2954763";" 2214472";" 1200791";"  613927";"  400810";"  116294";"  132466";"  152050"
"100";"A045844";"2004MM11";"   34764";"   17382";"   17382";" 3247807";" 1626629";" 1621178";" 3247807";" 2176382";" 1754825";" 1071425";"  532964";"  370550";"   92920";"  146895";"  130735"
"101";"A045844";"2004MM12";"   33328";"   16715";"   16613";" 3102830";" 1513011";" 1589819";" 3102830";" 2003444";" 1621440";" 1099205";"  556277";"  372983";"  102707";"  152514";"  117762"
"102";"A045844";"2004KW04";"  108236";"   54173";"   54063";"10506191";" 5245222";" 5260969";"10506191";" 7134589";" 5590737";" 3371421";" 1703168";" 1144343";"  311921";"  431875";"  400547"
"103";"A045844";"2004JJ00";"  440930";"  220442";"  220488";"44575911";"22208099";"22367812";"44575911";"30980281";"24133924";"13595449";" 7030169";" 4559950";" 1376573";" 1617829";" 1565548"
"104";"A045844";"2005MM01";"   32890";"   16401";"   16489";" 3082853";" 1553002";" 1529851";" 3082853";" 1951329";" 1653347";" 1131524";"  555620";"  391734";"   93044";"  173174";"  125516"
"105";"A045844";"2005MM02";"   31171";"   15571";"   15600";" 2960333";" 1471477";" 1488856";" 2960333";" 1958458";" 1675119";" 1001875";"  486369";"  343764";"   81494";"  146612";"  115658"
"106";"A045844";"2005MM03";"   34811";"   17406";"   17405";" 3442365";" 1727088";" 1715277";" 3442365";" 2295386";" 1952352";" 1146979";"  579824";"  377113";"   97907";"  145925";"  133281"
"107";"A045844";"2005KW01";"   98872";"   49378";"   49494";" 9485551";" 4751567";" 4733984";" 9485551";" 6205173";" 5280818";" 3280378";" 1621813";" 1112611";"  272445";"  465711";"  374455"
"108";"A045844";"2005MM04";"   36879";"   18423";"   18456";" 3735323";" 1822611";" 1912712";" 3735323";" 2575623";" 2149447";" 1159700";"  595823";"  391362";"  105003";"  141301";"  145058"
"109";"A045844";"2005MM05";"   40339";"   20172";"   20167";" 4328422";" 2159477";" 2168945";" 4328422";" 3135750";" 2470483";" 1192672";"  645783";"  379714";"  105519";"  129437";"  144758"
"110";"A045844";"2005MM06";"   39112";"   19561";"   19551";" 4196547";" 2081012";" 2115535";" 4196547";" 2979792";" 2417201";" 1216755";"  663236";"  387199";"  106042";"  131961";"  149196"
"111";"A045844";"2005KW02";"  116330";"   58156";"   58174";"12260292";" 6063100";" 6197192";"12260292";" 8691165";" 7037131";" 3569127";" 1904842";" 1158275";"  316564";"  402699";"  439012"
"112";"A045844";"2005MM07";"   40765";"   20379";"   20386";" 4795477";" 2243374";" 2552103";" 4795477";" 3400920";" 2641033";" 1394557";"  731989";"  445891";"  130270";"  154843";"  160778"
"113";"A045844";"2005MM08";"   40730";"   20364";"   20366";" 4695502";" 2459777";" 2235725";" 4695502";" 3312280";" 2606011";" 1383222";"  719438";"  443736";"  132414";"  152567";"  158755"
"114";"A045844";"2005MM09";"   39298";"   19652";"   19646";" 4377505";" 2181782";" 2195723";" 4377505";" 3107260";" 2541122";" 1270244";"  659116";"  416169";"  109975";"  143016";"  163178"
"115";"A045844";"2005KW03";"  120793";"   60395";"   60398";"13868484";" 6884933";" 6983551";"13868484";" 9820460";" 7788166";" 4048023";" 2110543";" 1305796";"  372659";"  450426";"  482711"
"116";"A045844";"2005MM10";"   39653";"   19834";"   19819";" 4297973";" 2180117";" 2117856";" 4297973";" 3068456";" 2446887";" 1229517";"  627559";"  403631";"   99092";"  148304";"  156235"
"117";"A045844";"2005MM11";"   34418";"   17204";"   17214";" 3362422";" 1678268";" 1684154";" 3362422";" 2261255";" 1950206";" 1101167";"  536345";"  385763";"   96394";"  151088";"  138281"
"118";"A045844";"2005MM12";"   32387";"   16213";"   16174";" 3213586";" 1564959";" 1648627";" 3213586";" 2101645";" 1808984";" 1111941";"  546925";"  383514";"  102483";"  157100";"  123931"
"119";"A045844";"2005KW04";"  106458";"   53251";"   53207";"10873981";" 5423344";" 5450637";"10873981";" 7431356";" 6206077";" 3442625";" 1710829";" 1172908";"  297969";"  456492";"  418447"
"120";"A045844";"2005JJ00";"  442453";"  221180";"  221273";"46488308";"23122944";"23365364";"46488308";"32148154";"26312192";"14340153";" 7348027";" 4749590";" 1259637";" 1775328";" 1714625"
"121";"A045844";"2006MM01";"   33363";"   16651";"   16712";" 3167956";" 1600916";" 1567040";" 3167956";" 2026452";" 1733258";" 1141504";"  544084";"  403163";"   96622";"  177102";"  129439"
"122";"A045844";"2006MM02";"   31463";"   15718";"   15745";" 3001753";" 1478158";" 1523595";" 3001753";" 2007183";" 1741606";"  994474";"  458786";"  361768";"   81702";"  157869";"  122197"
"123";"A045844";"2006MM03";"   36570";"   18273";"   18297";" 3571343";" 1801205";" 1770138";" 3571343";" 2398490";" 2072751";" 1172853";"  570315";"  413340";"  103863";"  163668";"  145809"
"124";"A045844";"2006KW01";"  101396";"   50642";"   50754";" 9741052";" 4880279";" 4860773";" 9741052";" 6432125";" 5547615";" 3308831";" 1573185";" 1178271";"  282187";"  498639";"  397445"
"125";"A045844";"2006MM04";"   38031";"   19041";"   18990";" 3990145";" 1947062";" 2043083";" 3990145";" 2769772";" 2372942";" 1220370";"  609323";"  427322";"  116180";"  160960";"  150182"
"126";"A045844";"2006MM05";"   42459";"   21222";"   21237";" 4472259";" 2237114";" 2235145";" 4472259";" 3257982";" 2715743";" 1214242";"  636673";"  404405";"  103016";"  149916";"  151473"
"127";"A045844";"2006MM06";"   41764";"   20862";"   20902";" 4487988";" 2239408";" 2248580";" 4487988";" 3225022";" 2699389";" 1262966";"  663559";"  420297";"  111953";"  154966";"  153378"
"128";"A045844";"2006KW02";"  122254";"   61125";"   61129";"12950392";" 6423584";" 6526808";"12950392";" 9252776";" 7788074";" 3697578";" 1909555";" 1252024";"  331149";"  465842";"  455033"
"129";"A045844";"2006MM07";"   43278";"   21612";"   21666";" 5021544";" 2346390";" 2675154";" 5021544";" 3608394";" 2912607";" 1413149";"  710743";"  461931";"  129971";"  169610";"  162350"
"130";"A045844";"2006MM08";"   43024";"   21491";"   21533";" 4877589";" 2561406";" 2316183";" 4877589";" 3467992";" 2799723";" 1409595";"  695529";"  467164";"  136930";"  165453";"  164781"
"131";"A045844";"2006MM09";"   41588";"   20763";"   20825";" 4563348";" 2281805";" 2281543";" 4563348";" 3270084";" 2733424";" 1293264";"  650356";"  433163";"  102557";"  158376";"  172230"
"132";"A045844";"2006KW03";"  127890";"   63866";"   64024";"14462481";" 7189601";" 7272880";"14462481";"10346470";" 8445754";" 4116008";" 2056628";" 1362258";"  369458";"  493439";"  499361"
"133";"A045844";"2006MM10";"   42396";"   21188";"   21208";" 4452338";" 2250255";" 2202083";" 4452338";" 3172420";" 2636430";" 1279916";"  635102";"  430348";"   97587";"  163162";"  169599"
"134";"A045844";"2006MM11";"   37942";"   18958";"   18984";" 3535989";" 1777377";" 1758612";" 3535989";" 2411766";" 2094362";" 1124223";"  541302";"  391984";"   85526";"  160249";"  146209"
"135";"A045844";"2006MM12";"   35454";"   17744";"   17710";" 3454304";" 1678294";" 1776010";" 3454304";" 2277280";" 1961287";" 1177024";"  579243";"  399460";"   96980";"  168906";"  133574"
"136";"A045844";"2006KW04";"  115792";"   57890";"   57902";"11442631";" 5705926";" 5736705";"11442631";" 7861466";" 6692079";" 3581163";" 1755647";" 1221792";"  280093";"  492317";"  449382"
"137";"A045844";"2006JJ00";"  467332";"  233523";"  233809";"48596556";"24199390";"24397166";"48596556";"33892837";"28473522";"14703580";" 7295015";" 5014345";" 1262887";" 1950237";" 1801221"
"138";"A045844";"2007MM01";"   35860";"   17887";"   17973";" 3331523";" 1697485";" 1634038";" 3331523";" 2154328";" 1873722";" 1177195";"  563084";"  412674";"   92990";"  185303";"  134381"
"139";"A045844";"2007MM02";"   34110";"   17024";"   17086";" 3213977";" 1582442";" 1631535";" 3213977";" 2176662";" 1898232";" 1037315";"  483069";"  371367";"   78374";"  163181";"  129812"
"140";"A045844";"2007MM03";"   39102";"   19522";"   19580";" 3896807";" 1974602";" 1922205";" 3896807";" 2666860";" 2322176";" 1229947";"  597245";"  425611";"   97588";"  170141";"  157882"
"141";"A045844";"2007KW01";"  109072";"   54433";"   54639";"10442307";" 5254529";" 5187778";"10442307";" 6997850";" 6094130";" 3444457";" 1643398";" 1209652";"  268952";"  518625";"  422075"
"142";"A045844";"2007MM04";"   39584";"   19782";"   19802";" 4121803";" 2015658";" 2106145";" 4121803";" 2902079";" 2506627";" 1219724";"  613711";"  424079";"  105707";"  157905";"  160467"
"143";"A045844";"2007MM05";"   43408";"   21678";"   21730";" 4566599";" 2293318";" 2273281";" 4566599";" 3320595";" 2805178";" 1246004";"  660927";"  406831";"  101127";"  144737";"  160967"
"144";"A045844";"2007MM06";"   42247";"   21088";"   21159";" 4529566";" 2254865";" 2274701";" 4529566";" 3243769";" 2741616";" 1285796";"  674787";"  424740";"  104531";"  153622";"  166587"
"145";"A045844";"2007KW02";"  125239";"   62548";"   62691";"13217968";" 6563841";" 6654127";"13217968";" 9466443";" 8053421";" 3751524";" 1949425";" 1255650";"  311365";"  456264";"  488021"
"146";"A045844";"2007MM07";"   44096";"   22029";"   22067";" 5172312";" 2424836";" 2747476";" 5172312";" 3710179";" 3086383";" 1462127";"  740303";"  467095";"  124426";"  169346";"  173323"
"147";"A045844";"2007MM08";"   44083";"   22017";"   22066";" 5121598";" 2703161";" 2418437";" 5121598";" 3650866";" 3042764";" 1470730";"  739100";"  475661";"  136961";"  163187";"  175513"
"148";"A045844";"2007MM09";"   41815";"   20882";"   20933";" 4713449";" 2352209";" 2361240";" 4713449";" 3375043";" 2858529";" 1338406";"  689846";"  432203";"   97825";"  154270";"  180108"
"149";"A045844";"2007KW03";"  129994";"   64928";"   65066";"15007359";" 7480206";" 7527153";"15007359";"10736088";" 8987676";" 4271263";" 2169249";" 1374959";"  359212";"  486803";"  528944"
"150";"A045844";"2007MM10";"   42668";"   21313";"   21355";" 4656638";" 2359933";" 2296705";" 4656638";" 3304633";" 2780711";" 1352005";"  677302";"  449193";"  106027";"  162681";"  180485"
"151";"A045844";"2007MM11";"   37079";"   18519";"   18560";" 3647578";" 1833621";" 1813957";" 3647578";" 2462672";" 2149206";" 1184899";"  570558";"  412065";"   93479";"  168019";"  150567"
"152";"A045844";"2007MM12";"   35454";"   17727";"   17727";" 3545823";" 1734500";" 1811323";" 3545823";" 2320443";" 2019685";" 1225380";"  600910";"  417600";"  107197";"  173206";"  137197"
"153";"A045844";"2007KW04";"  115201";"   57559";"   57642";"11850039";" 5928054";" 5921985";"11850039";" 8087748";" 6949602";" 3762284";" 1848770";" 1278858";"  306703";"  503906";"  468249"
"154";"A045844";"2007JJ00";"  479506";"  239468";"  240038";"50517673";"25226630";"25291043";"50517673";"35288129";"30084829";"15229528";" 7610842";" 5119119";" 1246232";" 1965598";" 1907289"
"155";"A045844";"2008MM01";"   35963";"   17929";"   18034";" 3388686";" 1719180";" 1669506";" 3388686";" 2189398";" 1893986";" 1199286";"  571163";"  425628";"   94755";"  188743";"  142130"
"156";"A045844";"2008MM02";"   34673";"   17325";"   17348";" 3348700";" 1654896";" 1693804";" 3348700";" 2264336";" 1969408";" 1084357";"  504413";"  390757";"   85586";"  174633";"  130538"
"157";"A045844";"2008MM03";"   37967";"   18958";"   19009";" 3973721";" 2008137";" 1965584";" 3973721";" 2689359";" 2328333";" 1284362";"  618652";"  453843";"  110469";"  182250";"  161124"
"158";"A045844";"2008KW01";"  108603";"   54212";"   54391";"10711107";" 5382213";" 5328894";"10711107";" 7143093";" 6191727";" 3568005";" 1694228";" 1270228";"  290810";"  545626";"  433792"
"159";"A045844";"2008MM04";"   40127";"   20055";"   20072";" 4156519";" 1986749";" 2169770";" 4156519";" 2884980";" 2460849";" 1271539";"  641553";"  440503";"  109717";"  165132";"  165654"
"160";"A045844";"2008MM05";"   43416";"   21701";"   21715";" 4713826";" 2414857";" 2298969";" 4713826";" 3374084";" 2814759";" 1339742";"  719165";"  425245";"  106998";"  158805";"  159442"
"161";"A045844";"2008MM06";"   42659";"   21335";"   21324";" 4704148";" 2314121";" 2390027";" 4704148";" 3332943";" 2787893";" 1371205";"  734132";"  431023";"  110902";"  160510";"  159611"
"162";"A045844";"2008KW02";"  126202";"   63091";"   63111";"13574493";" 6715727";" 6858766";"13574493";" 9592007";" 8063501";" 3982486";" 2094850";" 1296771";"  327617";"  484447";"  484707"
"163";"A045844";"2008MM07";"   44164";"   22072";"   22092";" 5175950";" 2474763";" 2701187";" 5175950";" 3657271";" 3013229";" 1518679";"  785198";"  474816";"  128560";"  177135";"  169121"
"164";"A045844";"2008MM08";"   43134";"   21557";"   21577";" 5025767";" 2655629";" 2370138";" 5025767";" 3507332";" 2910442";" 1518435";"  789682";"  476732";"  133740";"  172954";"  170038"
"165";"A045844";"2008MM09";"   41827";"   20922";"   20905";" 4600637";" 2298267";" 2302370";" 4600637";" 3259929";" 2738787";" 1340708";"  714221";"  418324";"   97986";"  156966";"  163372"
"166";"A045844";"2008KW03";"  129125";"   64551";"   64574";"14802354";" 7428659";" 7373695";"14802354";"10424532";" 8662458";" 4377822";" 2289101";" 1369872";"  360286";"  507055";"  502531"
"167";"A045844";"2008MM10";"   42188";"   21095";"   21093";" 4560314";" 2311797";" 2248517";" 4560314";" 3173983";" 2643938";" 1386331";"  701390";"  449784";"  112514";"  165621";"  171649"
"168";"A045844";"2008MM11";"   34683";"   17345";"   17338";" 3443549";" 1736355";" 1707194";" 3443549";" 2280659";" 1973653";" 1162890";"  554525";"  402056";"   96959";"  160428";"  144669"
"169";"A045844";"2008MM12";"   32762";"   16397";"   16365";" 3333873";" 1632437";" 1701436";" 3333873";" 2139286";" 1845029";" 1194587";"  588793";"  401079";"  102200";"  166126";"  132753"
"170";"A045844";"2008KW04";"  109633";"   54837";"   54796";"11337736";" 5680589";" 5657147";"11337736";" 7593928";" 6462620";" 3743808";" 1844708";" 1252919";"  311673";"  492175";"  449071"
"171";"A045844";"2008JJ00";"  473563";"  236691";"  236872";"50425690";"25207188";"25218502";"50425690";"34753560";"29380306";"15672121";" 7922887";" 5189790";" 1290386";" 2029303";" 1870101"
"172";"A045844";"2009MM01";"   32441";"   16187";"   16254";" 3072606";" 1564965";" 1507641";" 3072606";" 1931138";" 1656825";" 1141468";"  545365";"  398487";"   89904";"  175958";"  132625"
"173";"A045844";"2009MM02";"   30076";"   15035";"   15041";" 2891262";" 1432485";" 1458777";" 2891262";" 1931692";" 1664009";"  959570";"  432999";"  343724";"   76367";"  145826";"  121531"
"174";"A045844";"2009MM03";"   34246";"   17121";"   17125";" 3390581";" 1719615";" 1670966";" 3390581";" 2276647";" 1962892";" 1113934";"  532118";"  386576";"   95076";"  151166";"  140334"
"175";"A045844";"2009KW01";"   96763";"   48343";"   48420";" 9354449";" 4717065";" 4637384";" 9354449";" 6139477";" 5283726";" 3214972";" 1510482";" 1128787";"  261347";"  472950";"  394490"
"176";"A045844";"2009MM04";"   36224";"   18108";"   18116";" 3888685";" 1886896";" 2001789";" 3888685";" 2679421";" 2266684";" 1209264";"  600938";"  414098";"  112737";"  144963";"  156398"
"177";"A045844";"2009MM05";"   38787";"   19388";"   19399";" 4173577";" 2122143";" 2051434";" 4173577";" 2987262";" 2484931";" 1186315";"  625117";"  371702";"   96909";"  132997";"  141796"
"178";"A045844";"2009MM06";"   37849";"   18923";"   18926";" 4130139";" 2073981";" 2056158";" 4130139";" 2918724";" 2434568";" 1211415";"  648069";"  369844";"  100832";"  133087";"  135925"
"179";"A045844";"2009KW02";"  112860";"   56419";"   56441";"12192401";" 6083020";" 6109381";"12192401";" 8585407";" 7186183";" 3606994";" 1874124";" 1155644";"  310478";"  411047";"  434119"
"180";"A045844";"2009MM07";"   40351";"   20168";"   20183";" 4851476";" 2275515";" 2575961";" 4851476";" 3427550";" 2825891";" 1423926";"  709487";"  452007";"  127042";"  155847";"  169118"
"181";"A045844";"2009MM08";"   39865";"   19932";"   19933";" 4811406";" 2553928";" 2257478";" 4811406";" 3364375";" 2792342";" 1447031";"  718515";"  470213";"  132335";"  158437";"  179441"
"182";"A045844";"2009MM09";"   37832";"   18915";"   18917";" 4322719";" 2170571";" 2152148";" 4322719";" 3060047";" 2569518";" 1262672";"  639598";"  410873";"   91728";"  145899";"  173246"
"183";"A045844";"2009KW03";"  118048";"   59015";"   59033";"13985601";" 7000014";" 6985587";"13985601";" 9851972";" 8187751";" 4133629";" 2067600";" 1333093";"  351105";"  460183";"  521805"
"184";"A045844";"2009MM10";"   37867";"   18931";"   18936";" 4274814";" 2164348";" 2110466";" 4274814";" 2968577";" 2455476";" 1306237";"  628841";"  437420";"  103767";"  163425";"  170228"
"185";"A045844";"2009MM11";"   32681";"   16355";"   16326";" 3355439";" 1695362";" 1660077";" 3355439";" 2246696";" 1936669";" 1108743";"  507897";"  398432";"   91927";"  161560";"  144945"
"186";"A045844";"2009MM12";"   30910";"   15479";"   15431";" 3293039";" 1620230";" 1672809";" 3293039";" 2129192";" 1828019";" 1163847";"  543259";"  409100";"  100746";"  168537";"  139817"
"187";"A045844";"2009KW04";"  101458";"   50765";"   50693";"10923292";" 5479940";" 5443352";"10923292";" 7344465";" 6220164";" 3578827";" 1679997";" 1244952";"  296440";"  493522";"  454990"
"188";"A045844";"2009JJ00";"  429129";"  214542";"  214587";"46455743";"23280039";"23175704";"46455743";"31921321";"26877824";"14534422";" 7132203";" 4862476";" 1219370";" 1837702";" 1805404"
"189";"A045844";"2010MM01";"   31321";"   15634";"   15687";" 3114971";" 1579515";" 1535456";" 3114971";" 1963752";" 1671903";" 1151219";"  524222";"  414094";"   90772";"  178452";"  144870"
"190";"A045844";"2010MM02";"   29857";"   14930";"   14927";" 3049444";" 1509935";" 1539509";" 3049444";" 2041702";" 1753180";" 1007742";"  438838";"  371799";"   81450";"  154687";"  135662"
"191";"A045844";"2010MM03";"   34472";"   17239";"   17233";" 3697355";" 1878703";" 1818652";" 3697355";" 2481119";" 2121551";" 1216234";"  548050";"  446888";"  107724";"  172209";"  166955"
"192";"A045844";"2010KW01";"   95650";"   47803";"   47847";" 9861770";" 4968153";" 4893617";" 9861770";" 6486573";" 5546634";" 3375195";" 1511110";" 1232781";"  279946";"  505348";"  447487"
"193";"A045844";"2010MM04";"   29353";"   14667";"   14686";" 3213665";" 1566719";" 1646946";" 3213665";" 2157027";" 1816847";" 1056638";"  511218";"  366767";"   94737";"  135991";"  136039"
"194";"A045844";"2010MM05";"   38552";"   19286";"   19266";" 4447089";" 2239429";" 2207660";" 4447089";" 3156826";" 2588862";" 1290263";"  651795";"  428642";"  115489";"  141085";"  172068"
"195";"A045844";"2010MM06";"   38344";"   19176";"   19168";" 4442139";" 2227879";" 2214260";" 4442139";" 3085676";" 2572827";" 1356463";"  684091";"  450667";"  120685";"  150375";"  179607"
"196";"A045844";"2010KW02";"  106249";"   53129";"   53120";"12102893";" 6034027";" 6068866";"12102893";" 8399529";" 6978536";" 3703364";" 1847104";" 1246076";"  330911";"  427451";"  487714"
"197";"A045844";"2010MM07";"   41196";"   20588";"   20608";" 5119203";" 2411334";" 2707869";" 5119203";" 3567233";" 2927704";" 1551970";"  744723";"  510870";"  150924";"  172943";"  187003"
"198";"A045844";"2010MM08";"   40955";"   20490";"   20465";" 5058056";" 2688839";" 2369217";" 5058056";" 3535358";" 2918243";" 1522698";"  738406";"  510220";"  159234";"  166573";"  184413"
"199";"A045844";"2010MM09";"   38706";"   19357";"   19349";" 4623783";" 2317813";" 2305970";" 4623783";" 3255060";" 2719298";" 1368678";"  669638";"  461167";"  125472";"  150922";"  184773"
"200";"A045844";"2010KW03";"  120857";"   60435";"   60422";"14801042";" 7417986";" 7383056";"14801042";"10357651";" 8565245";" 4443346";" 2152767";" 1482257";"  435630";"  490438";"  556189"
"201";"A045844";"2010MM10";"   39368";"   19683";"   19685";" 4666071";" 2364053";" 2302018";" 4666071";" 3263544";" 2666957";" 1402527";"  666264";"  474620";"  132232";"  165119";"  177269"
"202";"A045844";"2010MM11";"   34145";"   17075";"   17070";" 3719403";" 1886706";" 1832697";" 3719403";" 2504810";" 2147545";" 1214593";"  551279";"  436053";"  119464";"  163734";"  152855"
"203";"A045844";"2010MM12";"   31123";"   15588";"   15535";" 3440349";" 1699164";" 1741185";" 3440349";" 2209325";" 1889371";" 1231024";"  567866";"  434161";"  121532";"  172299";"  140330"
"204";"A045844";"2010KW04";"  104636";"   52346";"   52290";"11825823";" 5949923";" 5875900";"11825823";" 7977679";" 6703873";" 3848144";" 1785409";" 1344834";"  373228";"  501152";"  470454"
"205";"A045844";"2010JJ00";"  427392";"  213713";"  213679";"48591528";"24370089";"24221439";"48591528";"33221432";"27794288";"15370049";" 7296390";" 5305948";" 1419715";" 1924389";" 1961844"
"206";"A045844";"2011MM01";"   32992";"   16470";"   16522";" 3466587";" 1763962";" 1702625";" 3466587";" 2225510";" 1901205";" 1241073";"  543475";"  463311";"  117751";"  184480";"  161080"
"207";"A045844";"2011MM02";"   30605";"   15302";"   15303";" 3251624";" 1610726";" 1640898";" 3251624";" 2219657";" 1908174";" 1031967";"  449995";"  412123";"  107744";"  161993";"  142386"
"208";"A045844";"2011MM03";"   35822";"   17907";"   17915";" 3921482";" 1994598";" 1926884";" 3921482";" 2717875";" 2332878";" 1203605";"  559728";"  457726";"  124860";"  170818";"  162048"
"209";"A045844";"2011KW01";"   99419";"   49679";"   49740";"10639693";" 5369286";" 5270407";"10639693";" 7163042";" 6142257";" 3476645";" 1553198";" 1333160";"  350355";"  517291";"  465514"
"210";"A045844";"2011MM04";"   38703";"   19349";"   19354";" 4466794";" 2193871";" 2272923";" 4466794";" 3169194";" 2672493";" 1297600";"  633837";"  460568";"  138211";"  160157";"  162200"
"211";"A045844";"2011MM05";"   42379";"   21197";"   21182";" 4916693";" 2485110";" 2431583";" 4916693";" 3608363";" 2986401";" 1308330";"  673676";"  450690";"  132202";"  148688";"  169800"
"212";"A045844";"2011MM06";"   41139";"   20560";"   20579";" 4939490";" 2480462";" 2459028";" 4939490";" 3568565";" 2985658";" 1370898";"  711999";"  459354";"  140583";"  148208";"  170563"
"213";"A045844";"2011KW02";"  122221";"   61106";"   61115";"14322977";" 7159443";" 7163534";"14322977";"10346122";" 8644552";" 3976828";" 2019512";" 1370612";"  410996";"  457053";"  502563"
"214";"A045844";"2011MM07";"   43761";"   21871";"   21890";" 5627276";" 2668554";" 2958722";" 5627276";" 4044394";" 3313919";" 1582882";"  779420";"  533805";"  170029";"  171228";"  192548"
"215";"A045844";"2011MM08";"   43822";"   21911";"   21911";" 5540569";" 2904186";" 2636383";" 5540569";" 3973627";" 3267858";" 1566916";"  779718";"  535367";"  171110";"  169815";"  194442"
"216";"A045844";"2011MM09";"   41819";"   20915";"   20904";" 5128892";" 2586515";" 2542377";" 5128892";" 3704535";" 3084401";" 1424357";"  707812";"  490133";"  144481";"  156508";"  189144"
"217";"A045844";"2011KW03";"  129402";"   64697";"   64705";"16296737";" 8159255";" 8137482";"16296737";"11722556";" 9666178";" 4574155";" 2266950";" 1559305";"  485620";"  497551";"  576134"
"218";"A045844";"2011MM10";"   42073";"   21041";"   21032";" 5024163";" 2544469";" 2479694";" 5024163";" 3602947";" 2945214";" 1421216";"  687339";"  498214";"  142467";"  165739";"  190008"
"219";"A045844";"2011MM11";"   34902";"   17455";"   17447";" 3807138";" 1925189";" 1881949";" 3807138";" 2623838";" 2245752";" 1183300";"  539229";"  427648";"  118906";"  153569";"  155173"
"220";"A045844";"2011MM12";"   34313";"   17171";"   17142";" 3777434";" 1840313";" 1937121";" 3777434";" 2543922";" 2196206";" 1233510";"  568994";"  445089";"  124699";"  171839";"  148551"
"221";"A045844";"2011KW04";"  111288";"   55667";"   55621";"12608735";" 6309971";" 6298764";"12608735";" 8770707";" 7387172";" 3838026";" 1795562";" 1370951";"  386072";"  491147";"  493732"
"222";"A045844";"2011JJ00";"  462330";"  231149";"  231181";"53868142";"26997955";"26870187";"53868142";"38002427";"31840159";"15865654";" 7635222";" 5634028";" 1633043";" 1963042";" 2037943"
"223";"A045844";"2012MM01";"   34162";"   17064";"   17098";" 3675761";" 1878969";" 1796792";" 3675761";" 2444953";" 2093549";" 1230808";"  552784";"  458249";"  120402";"  182011";"  155836"
"224";"A045844";"2012MM02";"   33042";"   16519";"   16523";" 3552136";" 1743950";" 1808186";" 3552136";" 2432008";" 2090461";" 1120126";"  493172";"  417150";"  112158";"  163542";"  141450"
"225";"A045844";"2012MM03";"   37190";"   18577";"   18613";" 4177498";" 2128958";" 2048540";" 4177498";" 2895625";" 2479790";" 1281873";"  582615";"  475665";"  134027";"  170677";"  170961"
"226";"A045844";"2012KW01";"  104394";"   52160";"   52234";"11405395";" 5751877";" 5653518";"11405395";" 7772586";" 6663800";" 3632807";" 1628571";" 1351064";"  366587";"  516230";"  468247"
"227";"A045844";"2012MM04";"   38974";"   19493";"   19481";" 4568847";" 2241495";" 2327352";" 4568847";" 3251568";" 2725909";" 1317277";"  632795";"  465890";"  132969";"  155130";"  177791"
"228";"A045844";"2012MM05";"   42648";"   21317";"   21331";" 5027940";" 2524338";" 2503602";" 5027940";" 3679671";" 3013899";" 1348267";"  689656";"  453011";"  121092";"  146795";"  185124"
"229";"A045844";"2012MM06";"   41834";"   20910";"   20924";" 5078079";" 2535350";" 2542729";" 5078079";" 3655218";" 2993552";" 1422861";"  737922";"  467364";"  121150";"  152134";"  194080"
"230";"A045844";"2012KW02";"  123456";"   61720";"   61736";"14674866";" 7301183";" 7373683";"14674866";"10586457";" 8733360";" 4088405";" 2060373";" 1386265";"  375211";"  454059";"  556995"
"231";"A045844";"2012MM07";"   44593";"   22300";"   22293";" 5759003";" 2713559";" 3045444";" 5759003";" 4149748";" 3331102";" 1609251";"  800062";"  517864";"  138370";"  166394";"  213100"
"232";"A045844";"2012MM08";"   44353";"   22192";"   22161";" 5671424";" 2971537";" 2699887";" 5671424";" 4043632";" 3273877";" 1627787";"  804095";"  533945";"  150506";"  166909";"  216530"
"233";"A045844";"2012MM09";"   41799";"   20913";"   20886";" 5239374";" 2638183";" 2601191";" 5239374";" 3776436";" 3103457";" 1462937";"  730943";"  487049";"  124553";"  153352";"  209144"
"234";"A045844";"2012KW03";"  130745";"   65405";"   65340";"16669801";" 8323279";" 8346522";"16669801";"11969816";" 9708436";" 4699975";" 2335100";" 1538858";"  413429";"  486655";"  638774"
"235";"A045844";"2012MM10";"   42082";"   21045";"   21037";" 5100023";" 2585686";" 2514337";" 5100023";" 3663822";" 2983302";" 1436201";"  687633";"  494575";"  138800";"  157513";"  198262"
"236";"A045844";"2012MM11";"   34833";"   17412";"   17421";" 3944666";" 1991565";" 1953101";" 3944666";" 2725085";" 2320114";" 1219581";"  548682";"  442022";"  117274";"  165100";"  159648"
"237";"A045844";"2012MM12";"   33071";"   16555";"   16516";" 3858569";" 1880368";" 1978201";" 3858569";" 2568570";" 2191484";" 1289998";"  581768";"  471229";"  130644";"  184843";"  155742"
"238";"A045844";"2012KW04";"  109986";"   55012";"   54974";"12903258";" 6457619";" 6445639";"12903258";" 8957477";" 7494900";" 3945780";" 1818083";" 1407826";"  386718";"  507456";"  513652"
"239";"A045844";"2012JJ00";"  468581";"  234297";"  234284";"55653320";"27833958";"27819362";"55653320";"39286336";"32600496";"16366967";" 7842127";" 5684013";" 1541945";" 1964400";" 2177668"
"240";"A045844";"2013MM01";"   33360";"   16656";"   16704";" 3670053";" 1866007";" 1804046";" 3670053";" 2397295";" 2028212";" 1272757";"  565379";"  469735";"  121477";"  189528";"  158730"
"241";"A045844";"2013MM02";"   31936";"   15977";"   15959";" 3563751";" 1765193";" 1798558";" 3563751";" 2446050";" 2078835";" 1117697";"  480480";"  418008";"  111327";"  159885";"  146796"
"242";"A045844";"2013MM03";"   36854";"   18411";"   18443";" 4341934";" 2189392";" 2152542";" 4341934";" 3002942";" 2553793";" 1338992";"  608364";"  493470";"  137605";"  177813";"  178052"
"243";"A045844";"2013KW01";"  102150";"   51044";"   51106";"11575738";" 5820592";" 5755146";"11575738";" 7846287";" 6660840";" 3729446";" 1654223";" 1381213";"  370409";"  527226";"  483578"
"244";"A045844";"2013MM04";"   40217";"   20111";"   20106";" 4779391";" 2337110";" 2442281";" 4779391";" 3406408";" 2844533";" 1372983";"  664912";"  481788";"  131469";"  154166";"  196153"
"245";"A045844";"2013MM05";"   44108";"   22038";"   22070";" 5440427";" 2742625";" 2697802";" 5440427";" 3999143";" 3266362";" 1441284";"  740154";"  477309";"  129313";"  150420";"  197576"
"246";"A045844";"2013MM06";"   42758";"   21380";"   21378";" 5404974";" 2691770";" 2713204";" 5404974";" 3878158";" 3198351";" 1526816";"  790054";"  501155";"  139086";"  153598";"  208471"
"247";"A045844";"2013KW02";"  127083";"   63529";"   63554";"15624792";" 7771505";" 7853287";"15624792";"11283709";" 9309246";" 4341083";" 2195120";" 1460252";"  399868";"  458184";"  602200"
"248";"A045844";"2013MM07";"   45286";"   22637";"   22649";" 5934128";" 2804005";" 3130123";" 5934128";" 4275317";" 3462194";" 1658811";"  835820";"  544779";"  159067";"  164126";"  221586"
"249";"A045844";"2013MM08";"   44963";"   22467";"   22496";" 5942981";" 3106009";" 2836972";" 5942981";" 4226967";" 3422342";" 1716010";"  854470";"  564431";"  171505";"  168922";"  224004"
"250";"A045844";"2013MM09";"   43316";"   21662";"   21654";" 5477811";" 2757247";" 2720564";" 5477811";" 3980218";" 3286926";" 1497593";"  764189";"  511569";"  144898";"  153126";"  213545"
"251";"A045844";"2013KW03";"  133565";"   66766";"   66799";"17354920";" 8667261";" 8687659";"17354920";"12482502";"10171462";" 4872414";" 2454479";" 1620779";"  475470";"  486174";"  659135"
"252";"A045844";"2013MM10";"   43084";"   21539";"   21545";" 5288928";" 2671780";" 2617148";" 5288928";" 3837144";" 3128468";" 1451782";"  711444";"  519316";"  151822";"  159698";"  207796"
"253";"A045844";"2013MM11";"   35980";"   17992";"   17988";" 4099344";" 2070177";" 2029167";" 4099344";" 2870409";" 2438155";" 1228935";"  562780";"  461137";"  138856";"  159165";"  163116"
"254";"A045844";"2013MM12";"   34930";"   17491";"   17439";" 4103791";" 2007376";" 2096415";" 4103791";" 2776539";" 2362450";" 1327252";"  612527";"  486943";"  156570";"  174901";"  155472"
"255";"A045844";"2013KW04";"  113994";"   57022";"   56972";"13492063";" 6749333";" 6742730";"13492063";" 9484092";" 7929073";" 4007969";" 1886751";" 1467396";"  447248";"  493764";"  526384"
"256";"A045844";"2013JJ00";"  476792";"  238361";"  238431";"58047513";"29008691";"29038822";"58047513";"41096590";"34070621";"16950912";" 8190573";" 5929640";" 1692995";" 1965348";" 2271297"
"257";"A045844";"2014MM01";"   34913";"   17426";"   17487";" 3937135";" 1993517";" 1943618";" 3937135";" 2614350";" 2219800";" 1322785";"  587706";"  508078";"  156234";"  182518";"  169326"
"258";"A045844";"2014MM02";"   32831";"   16406";"   16425";" 3770429";" 1859121";" 1911308";" 3770429";" 2615846";" 2227165";" 1154580";"  492916";"  450701";"  143655";"  155965";"  151081"
"259";"A045844";"2014MM03";"   38006";"   18995";"   19011";" 4489453";" 2277177";" 2212276";" 4489453";" 3147287";" 2682865";" 1342166";"  602415";"  508745";"  164360";"  163313";"  181072"
"260";"A045844";"2014KW01";"  105750";"   52827";"   52923";"12197017";" 6129815";" 6067202";"12197017";" 8377483";" 7129830";" 3819531";" 1683037";" 1467524";"  464249";"  501796";"  501479"
"261";"A045844";"2014MM04";"   41042";"   20512";"   20530";" 5075277";" 2465884";" 2609393";" 5075277";" 3674238";" 3081242";" 1401039";"  662304";"  514063";"  167717";"  154168";"  192178"
"262";"A045844";"2014MM05";"   44684";"   22329";"   22355";" 5618850";" 2830908";" 2787942";" 5618850";" 4159715";" 3438222";" 1459135";"  749101";"  498395";"  146254";"  154397";"  197744"
"263";"A045844";"2014MM06";"   43941";"   21973";"   21968";" 5642408";" 2848167";" 2794241";" 5642408";" 4143629";" 3459151";" 1498779";"  787091";"  501422";"  146204";"  153651";"  201567"
"264";"A045844";"2014KW02";"  129667";"   64814";"   64853";"16336535";" 8144959";" 8191576";"16336535";"11977582";" 9978615";" 4358953";" 2198496";" 1513880";"  460175";"  462216";"  591489"
"265";"A045844";"2014MM07";"   46402";"   23191";"   23211";" 6070119";" 2841054";" 3229065";" 6070119";" 4460368";" 3662868";" 1609750";"  807852";"  551138";"  165597";"  164677";"  220864"
"266";"A045844";"2014MM08";"   46479";"   23230";"   23249";" 6261369";" 3272798";" 2988571";" 6261369";" 4532170";" 3699926";" 1729196";"  844685";"  591932";"  191579";"  169062";"  231291"
"267";"A045844";"2014MM09";"   44912";"   22465";"   22447";" 5802996";" 2912901";" 2890095";" 5802996";" 4259359";" 3567929";" 1543637";"  795183";"  518448";"  152935";"  147984";"  217529"
"268";"A045844";"2014KW03";"  137793";"   68886";"   68907";"18134484";" 9026753";" 9107731";"18134484";"13251897";"10930723";" 4882583";" 2447720";" 1661518";"  510111";"  481723";"  669684"
"269";"A045844";"2014MM10";"   44688";"   22338";"   22350";" 5609100";" 2840063";" 2769037";" 5609100";" 4123691";" 3414529";" 1485409";"  739098";"  517343";"  162137";"  155667";"  199539"
"270";"A045844";"2014MM11";"   36888";"   18448";"   18440";" 4321292";" 2176743";" 2144549";" 4321292";" 3056363";" 2616062";" 1264929";"  585082";"  468455";"  142876";"  157122";"  168457"
"271";"A045844";"2014MM12";"   36238";"   18149";"   18089";" 4334189";" 2127306";" 2206883";" 4334189";" 3000165";" 2568783";" 1334024";"  624974";"  481491";"  153537";"  168662";"  159292"
"272";"A045844";"2014KW04";"  117814";"   58935";"   58879";"14264581";" 7144112";" 7120469";"14264581";"10180219";" 8599374";" 4084362";" 1949154";" 1467289";"  458550";"  481451";"  527288"
"273";"A045844";"2014JJ00";"  491024";"  245462";"  245562";"60932617";"30445639";"30486978";"60932617";"43787181";"36638542";"17145429";" 8278407";" 6110211";" 1893085";" 1927186";" 2289940"
"274";"A045844";"2015MM01";"   35424";"   17679";"   17745";" 4067159";" 2053582";" 2013577";" 4067159";" 2744657";" 2312445";" 1322502";"  602802";"  493748";"  149106";"  176454";"  168188"
"275";"A045844";"2015MM02";"   34013";"   17001";"   17012";" 3975652";" 1963234";" 2012418";" 3975652";" 2820468";" 2390153";" 1155184";"  507070";"  443475";"  134921";"  151836";"  156718"
"276";"A045844";"2015MM03";"   38723";"   19371";"   19352";" 4651418";" 2361147";" 2290271";" 4651418";" 3315573";" 2820395";" 1335845";"  622212";"  490769";"  148450";"  157953";"  184366"
"277";"A045844";"2015KW01";"  108160";"   54051";"   54109";"12694229";" 6377963";" 6316266";"12694229";" 8880698";" 7522993";" 3813531";" 1732084";" 1427992";"  432477";"  486243";"  509272"
"278";"A045844";"2015MM04";"   42263";"   21126";"   21137";" 5318300";" 2592791";" 2725509";" 5318300";" 3899799";" 3292141";" 1418501";"  697454";"  497191";"  159175";"  140795";"  197221"
"279";"A045844";"2015MM05";"   46525";"   23258";"   23267";" 6064935";" 3050274";" 3014661";" 6064935";" 4553124";" 3762407";" 1511809";"  801872";"  493971";"  155701";"  141172";"  197098"
"280";"A045844";"2015MM06";"   45459";"   22731";"   22728";" 5971077";" 2983254";" 2987823";" 5971077";" 4421466";" 3692930";" 1549610";"  831330";"  507478";"  157569";"  138453";"  211456"
"281";"A045844";"2015KW02";"  134247";"   67115";"   67132";"17354312";" 8626319";" 8727993";"17354312";"12874389";"10747478";" 4479920";" 2330656";" 1498640";"  472445";"  420420";"  605775"
"282";"A045844";"2015MM07";"   47783";"   23879";"   23904";" 6568499";" 3093605";" 3474894";" 6568499";" 4840842";" 3950815";" 1727657";"  872530";"  597346";"  193634";"  151270";"  252442"
"283";"A045844";"2015MM08";"   47532";"   23767";"   23765";" 6606203";" 3459913";" 3146290";" 6606203";" 4806548";" 3913482";" 1799652";"  893391";"  626315";"  210167";"  158593";"  257555"
"284";"A045844";"2015MM09";"   45886";"   22955";"   22931";" 6115762";" 3064261";" 3051501";" 6115762";" 4506062";" 3762021";" 1609700";"  836067";"  545266";"  170257";"  143685";"  231324"
"285";"A045844";"2015KW03";"  141201";"   70601";"   70600";"19290464";" 9617779";" 9672685";"19290464";"14153452";"11626318";" 5137009";" 2601988";" 1768927";"  574058";"  453548";"  741321"
"286";"A045844";"2015MM10";"   45332";"   22645";"   22687";" 5940890";" 2997692";" 2943198";" 5940890";" 4370946";" 3642116";" 1569944";"  796260";"  544140";"  181221";"  148016";"  214903"
"287";"A045844";"2015MM11";"   37962";"   18996";"   18966";" 4697506";" 2364328";" 2333178";" 4697506";" 3378124";" 2888890";" 1319382";"  619611";"  485474";"  171160";"  146868";"  167446"
"288";"A045844";"2015MM12";"   38065";"   19047";"   19018";" 4657214";" 2292144";" 2365070";" 4657214";" 3276177";" 2789599";" 1381037";"  656486";"  502158";"  185041";"  161434";"  155683"
"289";"A045844";"2015KW04";"  121359";"   60688";"   60671";"15295610";" 7654164";" 7641446";"15295610";"11025247";" 9320605";" 4270363";" 2072357";" 1531772";"  537422";"  456318";"  538032"
"290";"A045844";"2015JJ00";"  504967";"  252455";"  252512";"64634615";"32276225";"32358390";"64634615";"46933786";"39217394";"17700823";" 8737085";" 6227331";" 2016402";" 1816529";" 2394400"
"291";"A045844";"2016MM01";"   36709";"   18340";"   18369";" 4487365";" 2263317";" 2224048";" 4487365";" 3115183";" 2649796";" 1372180";"  634604";"  516877";"  177586";"  163095";"  176196"
"292";"A045844";"2016MM02";"   36774";"   18388";"   18386";" 4510127";" 2227376";" 2282751";" 4510127";" 3285911";" 2813967";" 1224216";"  550982";"  469137";"  168834";"  137090";"  163213"
"293";"A045844";"2016MM03";"   41451";"   20720";"   20731";" 5249454";" 2646268";" 2603186";" 5249454";" 3822589";" 3277090";" 1426864";"  679550";"  525372";"  197696";"  149813";"  177863"
"294";"A045844";"2016KW01";"  114934";"   57448";"   57486";"14246946";" 7136961";" 7109985";"14246946";"10223683";" 8740853";" 4023260";" 1865136";" 1511386";"  544116";"  449998";"  517272"
"295";"A045844";"2016MM04";"   44736";"   22366";"   22370";" 5837141";" 2826735";" 3010406";" 5837141";" 4318761";" 3692173";" 1518380";"  765596";"  546098";"  196947";"  154080";"  195071"
"296";"A045844";"2016MM05";"   48862";"   24431";"   24431";" 6408460";" 3261250";" 3147210";" 6408460";" 4860116";" 4134744";" 1548344";"  820679";"  525622";"  186586";"  151323";"  187713"
"297";"A045844";"2016MM06";"   46549";"   23271";"   23278";" 6203153";" 3095920";" 3107233";" 6203153";" 4648888";" 3969566";" 1554265";"  831150";"  538881";"  174390";"  154331";"  210160"
"298";"A045844";"2016KW02";"  140147";"   70068";"   70079";"18448754";" 9183905";" 9264849";"18448754";"13827765";"11796483";" 4620989";" 2417425";" 1610601";"  557923";"  459734";"  592944"
"299";"A045844";"2016MM07";"   50742";"   25362";"   25380";" 7074939";" 3325563";" 3749376";" 7074939";" 5271958";" 4457172";" 1802971";"  903224";"  648708";"  225401";"  177159";"  246148"
"300";"A045844";"2016MM08";"   51075";"   25540";"   25535";" 7115921";" 3718176";" 3397745";" 7115921";" 5274328";" 4430319";" 1841593";"  908028";"  664914";"  235578";"  178945";"  250391"
"301";"A045844";"2016MM09";"   48782";"   24380";"   24402";" 6572800";" 3299982";" 3272818";" 6572800";" 4913276";" 4222756";" 1659515";"  848398";"  586169";"  199355";"  164839";"  221975"
"302";"A045844";"2016KW03";"  150599";"   75282";"   75317";"20763660";"10343721";"10419939";"20763660";"15459562";"13110247";" 5304079";" 2659650";" 1899791";"  660334";"  520943";"  718514"
"303";"A045844";"2016MM10";"   48802";"   24404";"   24398";" 6445707";" 3262872";" 3182835";" 6445707";" 4798974";" 4103386";" 1646731";"  829436";"  586637";"  202260";"  168711";"  215666"
"304";"A045844";"2016MM11";"   40403";"   20205";"   20198";" 5162840";" 2594898";" 2567942";" 5162840";" 3744211";" 3238211";" 1418629";"  657404";"  538195";"  189631";"  169595";"  178969"
"305";"A045844";"2016MM12";"   40357";"   20190";"   20167";" 5211659";" 2554056";" 2657603";" 5211659";" 3693658";" 3173259";" 1518001";"  711129";"  568414";"  210371";"  174539";"  183504"
"306";"A045844";"2016KW04";"  129562";"   64799";"   64763";"16820206";" 8411826";" 8408380";"16820206";"12236843";"10514856";" 4583361";" 2197969";" 1693246";"  602262";"  512845";"  578139"
"307";"A045844";"2016JJ00";"  535242";"  267597";"  267645";"70279566";"35076413";"35203153";"70279566";"51747853";"44162439";"18531689";" 9140180";" 6715024";" 2364635";" 1943520";" 2406869"
"308";"A045844";"2017MM01";"   39687";"   19833";"   19854";" 5024395";" 2549832";" 2474563";" 5024395";" 3512887";" 3013205";" 1511500";"  684200";"  588788";"  211757";"  181368";"  195663"
"309";"A045844";"2017MM02";"   37318";"   18660";"   18658";" 4787727";" 2353424";" 2434303";" 4787727";" 3465376";" 2981790";" 1322349";"  581488";"  525507";"  190370";"  157063";"  178074"
"310";"A045844";"2017MM03";"   44013";"   22000";"   22013";" 5717190";" 2902551";" 2814639";" 5717190";" 4168287";" 3596858";" 1548901";"  720334";"  588547";"  216506";"  167836";"  204205"
"311";"A045844";"2017KW01";"  121018";"   60493";"   60525";"15529312";" 7805807";" 7723505";"15529312";"11146550";" 9591853";" 4382750";" 1986022";" 1702842";"  618633";"  506267";"  577942"
"312";"A045844";"2017MM04";"   46977";"   23488";"   23489";" 6525509";" 3189652";" 3335857";" 6525509";" 4817217";" 4154012";" 1708289";"  865902";"  602792";"  221739";"  161291";"  219762"
"313";"A045844";"2017MM05";"   51232";"   25617";"   25615";" 6988685";" 3523496";" 3465189";" 6988685";" 5266504";" 4555123";" 1722172";"  912406";"  591622";"  202338";"  159184";"  230100"
"314";"A045844";"2017MM06";"   49591";"   24778";"   24813";" 6904028";" 3464205";" 3439823";" 6904028";" 5208558";" 4500632";" 1695466";"  909338";"  582240";"  191352";"  162263";"  228625"
"315";"A045844";"2017KW02";"  147800";"   73883";"   73917";"20418222";"10177353";"10240869";"20418222";"15292279";"13209767";" 5125927";" 2687646";" 1776654";"  615429";"  482738";"  678487"
"316";"A045844";"2017MM07";"   52112";"   26050";"   26062";" 7532873";" 3560737";" 3972136";" 7532873";" 5649595";" 4816203";" 1883273";"  952462";"  660185";"  242016";"  174189";"  243980"
"317";"A045844";"2017MM08";"   52466";"   26227";"   26239";" 7608101";" 3944170";" 3663931";" 7608101";" 5702662";" 4833973";" 1905436";"  958942";"  660122";"  246512";"  174183";"  239427"
"318";"A045844";"2017MM09";"   49841";"   24915";"   24926";" 7044350";" 3555704";" 3488646";" 7044350";" 5298309";" 4554310";" 1746034";"  889357";"  613735";"  214627";"  167095";"  232013"
"319";"A045844";"2017KW03";"  154419";"   77192";"   77227";"22185324";"11060611";"11124713";"22185324";"16650566";"14204486";" 5534743";" 2800761";" 1934042";"  703155";"  515467";"  715420"
"320";"A045844";"2017MM10";"   50259";"   25126";"   25133";" 6975594";" 3517373";" 3458221";" 6975594";" 5228557";" 4490997";" 1747031";"  859618";"  624179";"  220567";"  170520";"  233092"
"321";"A045844";"2017MM11";"   41970";"   20982";"   20988";" 5657189";" 2848886";" 2808303";" 5657189";" 4107484";" 3550586";" 1549699";"  709103";"  579443";"  196697";"  183500";"  199246"
"322";"A045844";"2017MM12";"   40319";"   20168";"   20151";" 5437988";" 2656624";" 2781364";" 5437988";" 3831216";" 3288608";" 1606772";"  746677";"  592138";"  204646";"  197469";"  190023"
"323";"A045844";"2017KW04";"  132548";"   66276";"   66272";"18070771";" 9022883";" 9047888";"18070771";"13167257";"11330191";" 4903502";" 2315398";" 1795760";"  621910";"  551489";"  622361"
"324";"A045844";"2017JJ00";"  555785";"  277844";"  277941";"76203629";"38066654";"38136975";"76203629";"56256652";"48336297";"19946922";" 9789827";" 7209298";" 2559127";" 2055961";" 2594210"
"325";"A045844";"2018MM01";"   41247";"   20616";"   20631";" 5410899";" 2735932";" 2674967";" 5410899";" 3805859";" 3261769";" 1605039";"  734088";"  599996";"  200185";"  200566";"  199245"
"326";"A045844";"2018MM02";"   39014";"   19513";"   19501";" 5237331";" 2574649";" 2662682";" 5237331";" 3793051";" 3266343";" 1444277";"  641702";"  558192";"  184749";"  180872";"  192571"
"327";"A045844";"2018MM03";"   44687";"   22333";"   22354";" 6151187";" 3111952";" 3039235";" 6151187";" 4455464";" 3847170";" 1695721";"  795410";"  623321";"  215947";"  191275";"  216099"
"328";"A045844";"2018KW01";"  124948";"   62462";"   62486";"16799417";" 8422533";" 8376884";"16799417";"12054374";"10375282";" 4745037";" 2171200";" 1781509";"  600881";"  572713";"  607915"
"329";"A045844";"2018MM04";"   47362";"   23688";"   23674";" 6730695";" 3275700";" 3454995";" 6730695";" 4932741";" 4249588";" 1797945";"  903740";"  631721";"  221553";"  176696";"  233472"
"330";"A045844";"2018MM05";"   51151";"   25563";"   25588";" 7261667";" 3666643";" 3595024";" 7261667";" 5456899";" 4692775";" 1804763";"  962874";"  600868";"  195662";"  174269";"  230937"
"331";"A045844";"2018MM06";"   49764";"   24869";"   24895";" 7233806";" 3615253";" 3618553";" 7233806";" 5382900";" 4634311";" 1850902";"  991084";"  616508";"  200137";"  178626";"  237745"
"332";"A045844";"2018KW02";"  148277";"   74120";"   74157";"21226168";"10557596";"10668572";"21226168";"15772540";"13576674";" 5453610";" 2857698";" 1849097";"  617352";"  529591";"  702154"
"333";"A045844";"2018MM07";"   52126";"   26069";"   26057";" 7691695";" 3621660";" 4070035";" 7691695";" 5689224";" 4866077";" 2002465";" 1031791";"  676903";"  235740";"  191515";"  249648"
"334";"A045844";"2018MM08";"   52326";"   26155";"   26171";" 7786633";" 4018842";" 3767791";" 7786633";" 5733377";" 4878707";" 2053253";" 1044614";"  697731";"  249893";"  191120";"  256718"
"335";"A045844";"2018MM09";"   50660";"   25335";"   25325";" 7294410";" 3665569";" 3628841";" 7294410";" 5429424";" 4660871";" 1864974";"  969446";"  627225";"  206954";"  180637";"  239634"
"336";"A045844";"2018KW03";"  155112";"   77559";"   77553";"22772738";"11306071";"11466667";"22772738";"16852025";"14405655";" 5920692";" 3045851";" 2001859";"  692587";"  563272";"  746000"
"337";"A045844";"2018MM10";"   51475";"   25733";"   25742";" 7262779";" 3655800";" 3606979";" 7262779";" 5388538";" 4608191";" 1874239";"  942167";"  641115";"  212964";"  186368";"  241783"
"338";"A045844";"2018MM11";"   42585";"   21290";"   21295";" 5802548";" 2916663";" 2885885";" 5802548";" 4174366";" 3611752";" 1628182";"  770229";"  586210";"  189646";"  189625";"  206939"
"339";"A045844";"2018MM12";"   42149";"   21078";"   21071";" 5742668";" 2802933";" 2939735";" 5742668";" 4043822";" 3482320";" 1698838";"  816561";"  604756";"  203022";"  202731";"  199003"
"340";"A045844";"2018KW04";"  136209";"   68101";"   68108";"18807995";" 9375396";" 9432599";"18807995";"13606726";"11702263";" 5201259";" 2528957";" 1832081";"  605632";"  578724";"  647725"
"341";"A045844";"2018JJ00";"  564546";"  282242";"  282304";"79606318";"39661596";"39944722";"79606318";"58285665";"50059874";"21320598";"10603706";" 7464546";" 2516452";" 2244300";" 2703794"
"342";"A045844";"2019MM01";"   41285";"   20634";"   20651";" 5495052";" 2777666";" 2717386";" 5495052";" 3839988";" 3301806";" 1655064";"  771225";"  603791";"  201030";"  198530";"  204231"
"343";"A045844";"2019MM02";"   39204";"   19595";"   19609";" 5352301";" 2638163";" 2714138";" 5352301";" 3866027";" 3334887";" 1486271";"  678346";"  555091";"  192914";"  171647";"  190530"
"344";"A045844";"2019MM03";"   44649";"   22326";"   22323";" 6270788";" 3170209";" 3100579";" 6270788";" 4547261";" 3933286";" 1723527";"  835917";"  608705";"  220399";"  178766";"  209540"
"345";"A045844";"2019KW01";"  125138";"   62555";"   62583";"17118141";" 8586038";" 8532103";"17118141";"12253276";"10569979";" 4864862";" 2285488";" 1767587";"  614343";"  548943";"  604301"
"346";"A045844";"2019MM04";"   47934";"   23965";"   23969";" 6926059";" 3372752";" 3553307";" 6926059";" 5094415";" 4384512";" 1831643";"  936407";"  622830";"  228431";"  153991";"  240408"
"347";"A045844";"2019MM05";"   51719";"   25851";"   25868";" 7396960";" 3709789";" 3687171";" 7396960";" 5575054";" 4789936";" 1821903";"  997494";"  588567";"  205194";"  132977";"  250396"
"348";"A045844";"2019MM06";"   50135";"   25069";"   25066";" 7471334";" 3755096";" 3716238";" 7471334";" 5581133";" 4794624";" 1890194";" 1027668";"  599645";"  219552";"  130830";"  249263"
"349";"A045844";"2019KW02";"  149788";"   74885";"   74903";"21794353";"10837637";"10956716";"21794353";"16250602";"13969072";" 5543740";" 2961569";" 1811042";"  653177";"  417798";"  740067"
"350";"A045844";"2019MM07";"   51786";"   25885";"   25901";" 7730263";" 3633107";" 4097156";" 7730263";" 5714888";" 4863146";" 2015370";" 1064565";"  653541";"  250201";"  140403";"  262937"
"351";"A045844";"2019MM08";"   52127";"   26055";"   26072";" 7859458";" 4067875";" 3791583";" 7859458";" 5796841";" 4898661";" 2062607";" 1080202";"  667656";"  258566";"  144489";"  264601"
"352";"A045844";"2019MM09";"   51091";"   25557";"   25534";" 7486440";" 3755429";" 3731011";" 7486440";" 5597732";" 4783993";" 1888708";"  998333";"  611963";"  219766";"  137525";"  254672"
"353";"A045844";"2019KW03";"  155004";"   77497";"   77507";"23076161";"11456411";"11619750";"23076161";"17109461";"14545800";" 5966685";" 3143100";" 1933160";"  728533";"  422417";"  782210"
"354";"A045844";"2019MM10";"   51135";"   25573";"   25562";" 7354352";" 3708483";" 3645869";" 7354352";" 5481390";" 4671287";" 1872961";"  964346";"  617436";"  229952";"  138445";"  249039"
"355";"A045844";"2019MM11";"   42195";"   21088";"   21107";" 5885771";" 2957800";" 2927971";" 5885771";" 4237242";" 3663084";" 1648529";"  795614";"  581109";"  215511";"  148528";"  217070"
"356";"A045844";"2019MM12";"   42771";"   21395";"   21376";" 5938523";" 2900912";" 3037611";" 5938523";" 4210901";" 3633053";" 1727621";"  855812";"  593981";"  226190";"  158395";"  209396"
"357";"A045844";"2019KW04";"  136101";"   68056";"   68045";"19178646";" 9567195";" 9611451";"19178646";"13929533";"11967424";" 5249111";" 2615772";" 1792526";"  671653";"  445368";"  675505"
"358";"A045844";"2019JJ00";"  566031";"  282993";"  283038";"81167301";"40447281";"40720020";"81167301";"59542872";"51052275";"21624398";"11005929";" 7304315";" 2667706";" 1834526";" 2802083"
"359";"A045844";"2020MM01";"   41768";"   20884";"   20884";" 5595249";" 2825386";" 2769863";" 5595249";" 3933548";" 3387134";" 1661701";"  787734";"  593215";"  218446";"  159427";"  215342"
"360";"A045844";"2020MM02";"   39299";"   19645";"   19654";" 5281600";" 2616242";" 2665358";" 5281600";" 3850441";" 3319861";" 1431159";"  712192";"  450596";"  205224";"  141678";"  103694"
"361";"A045844";"2020MM03";"   28306";"   14184";"   14122";" 2773554";" 1462008";" 1311546";" 2773554";" 1916112";" 1646992";"  857437";"  436831";"  253678";"  111424";"   97016";"   45238"
"362";"A045844";"2020KW01";"  109373";"   54713";"   54660";"13650403";" 6903636";" 6746767";"13650403";" 9700101";" 8353987";" 3950297";" 1936757";" 1297489";"  535094";"  398121";"  364274"
"363";"A045844";"2020MM04";"    4759";"    2375";"    2384";"  133752";"   74778";"   58974";"  133752";"   75422";"   63142";"   58328";"   30099";"   24851";"    6143";"    9379";"    9329"
"364";"A045844";"2020MM05";"    6556";"    3270";"    3286";"  220120";"  116888";"  103232";"  220120";"  143839";"  122816";"   76281";"   42055";"   30485";"    5066";"   11729";"   13690"
"365";"A045844";"2020MM06";"    9336";"    4674";"    4662";"  526544";"  251076";"  275468";"  526544";"  393374";"  321438";"  133168";"   74685";"   50943";"   10856";"   21433";"   18654"
"366";"A045844";"2020KW02";"   20651";"   10319";"   10332";"  880416";"  442742";"  437674";"  880416";"  612635";"  507396";"  267777";"  146839";"  106279";"   22065";"   42541";"   41673"
"367";"A045844";"2020MM07";"   19701";"    9844";"    9857";" 1690515";"  760514";"  930001";" 1690515";" 1466056";" 1277703";"  224459";"  124208";"   78276";"   26724";"   25566";"   25986"
"368";"A045844";"2020MM08";"   27575";"   13760";"   13815";" 2242935";" 1198701";" 1044234";" 2242935";" 1996656";" 1740322";"  246279";"  147036";"   75065";"   27925";"   17882";"   29258"
"369";"A045844";"2020MM09";"   25290";"   12646";"   12644";" 1547263";"  794910";"  752353";" 1547263";" 1311330";" 1137459";"  235933";"  132894";"   72501";"   24604";"   16689";"   31208"
"370";"A045844";"2020KW03";"   72566";"   36250";"   36316";" 5480713";" 2754125";" 2726588";" 5480713";" 4774042";" 4155484";"  706671";"  404138";"  225842";"   79253";"   60137";"   86452"
"371";"A045844";"2020MM10";"   22028";"   11010";"   11018";" 1303123";"  658399";"  644724";" 1303123";" 1031534";"  881277";"  271589";"  146461";"   76382";"   30709";"   17506";"   28167"
"372";"A045844";"2020MM11";"   16283";"    8146";"    8137";"  965071";"  486521";"  478550";"  965071";"  691389";"  562092";"  273682";"  154035";"   72123";"   29952";"   22493";"   19678"
"373";"A045844";"2020MM12";"   17325";"    8684";"    8641";" 1306018";"  609520";"  696498";" 1306018";"  904778";"  749994";"  401239";"  227504";"   90238";"   44781";"   25330";"   20127"
"374";"A045844";"2020KW04";"   55636";"   27840";"   27796";" 3574212";" 1754440";" 1819772";" 3574212";" 2627701";" 2193363";"  946510";"  528000";"  238743";"  105442";"   65329";"   67972"
"375";"A045844";"2020JJ00";"  258226";"  129122";"  129104";"23585744";"11854943";"11730801";"23585744";"17714479";"15210230";" 5871255";" 3015734";" 1868353";"  741854";"  566128";"  560371"
"376";"A045844";"2021MM01";"   15907";"    7930";"    7977";"  909617";"  489232";"  420385";"  909617";"  590675";"  430085";"  318942";"  174464";"   77352";"   37553";"   22350";"   17449"
"377";"A045844";"2021MM02";"   11528";"    5763";"    5765";"  519827";"  260596";"  259231";"  519827";"  339063";"  266187";"  180763";"   88342";"   53244";"   24888";"   18262";"   10094"
"378";"A045844";"2021MM03";"   13228";"    6614";"    6614";"  676647";"  339259";"  337388";"  676647";"  447426";"  333551";"  229221";"  123707";"   68880";"   31593";"   22014";"   15273"
"379";"A045844";"2021KW01";"   40663";"   20307";"   20356";" 2106091";" 1089087";" 1017004";" 2106091";" 1377164";" 1029823";"  728926";"  386513";"  199476";"   94034";"   62626";"   42816"
"380";"A045844";"2021MM04";"   14891";"    7443";"    7448";"  817876";"  400390";"  417486";"  817876";"  567351";"  408988";"  250524";"  128293";"   79442";"   38019";"   21444";"   19979"
"381";"A045844";"2021MM05";"   16987";"    8484";"    8503";" 1169673";"  581427";"  588246";" 1169673";"  867506";"  664559";"  302166";"  169040";"   83368";"   40750";"   21106";"   21512"
"382";"A045844";"2021MM06";"   21701";"   10850";"   10851";" 1870330";"  899114";"  971216";" 1870330";" 1413413";" 1139237";"  456917";"  269639";"  100089";"   47623";"   26362";"   26104"
"383";"A045844";"2021KW02";"   53579";"   26777";"   26802";" 3857879";" 1880931";" 1976948";" 3857879";" 2848270";" 2212784";" 1009607";"  566972";"  262899";"  126392";"   68912";"   67595"
"384";"A045844";"2021MM07";"   33916";"   16972";"   16944";" 3515159";" 1584635";" 1930524";" 3515159";" 2757723";" 2231922";"  757434";"  442554";"  145553";"   82938";"   31657";"   30958"
"385";"A045844";"2021MM08";"   37282";"   18624";"   18658";" 4479180";" 2368993";" 2110187";" 4479180";" 3593589";" 2901482";"  885591";"  522054";"  168790";"   99406";"   33806";"   35578"
"386";"A045844";"2021MM09";"   35262";"   17630";"   17632";" 4013477";" 2048412";" 1965065";" 4013477";" 3298932";" 2670367";"  714544";"  435718";"  139194";"   75552";"   30401";"   33241"
"387";"A045844";"2021KW03";"  106460";"   53226";"   53234";"12007816";" 6002040";" 6005776";"12007816";" 9650244";" 7803771";" 2357569";" 1400326";"  453537";"  257896";"   95864";"   99777"
"388";"A045844";"2021MM10";"   36465";"   18222";"   18243";" 4395945";" 2241087";" 2154858";" 4395945";" 3613183";" 2798991";"  782762";"  475163";"  173363";"  104291";"   37117";"   31955"
"389";"A045844";"2021MM11";"   32026";"   16009";"   16017";" 3492940";" 1759024";" 1733916";" 3492940";" 2670142";" 1947510";"  822798";"  518786";"  186876";"  112633";"   47219";"   27024"
"390";"A045844";"2021MM12";"   33869";"   16962";"   16907";" 3208864";" 1481925";" 1726939";" 3208864";" 2277586";" 1685840";"  931275";"  593224";"  215160";"  128503";"   60260";"   26397"
"391";"A045844";"2021KW04";"  102360";"   51193";"   51167";"11097749";" 5482036";" 5615713";"11097749";" 8560911";" 6432341";" 2536835";" 1587173";"  575399";"  345427";"  144596";"   85376"
"392";"A045844";"2021JJ00";"  303062";"  151503";"  151559";"29069535";"14454094";"14615441";"29069535";"22436589";"17478719";" 6632937";" 3940984";" 1491311";"  823749";"  371998";"  295564"
"393";"A045844";"2022MM01";"   29604";"   14767";"   14837";" 2831598";" 1521503";" 1310095";" 2831598";" 2008228";" 1487892";"  823370";"  522154";"  177637";"  101785";"   53922";"   21930"
"394";"A045844";"2022MM02";"   27456";"   13750";"   13706";" 3040193";" 1491966";" 1548227";" 3040193";" 2279907";" 1670142";"  760285";"  455413";"  180089";"  112655";"   50494";"   16940"
"395";"A045844";"2022MM03";"   34568";"   17273";"   17295";" 4241663";" 2169929";" 2071734";" 4241663";" 3203309";" 2309343";" 1038352";"  632949";"  241852";"  156282";"   68398";"   17172"
"396";"A045844";"2022KW01";"   91628";"   45790";"   45838";"10113454";" 5183398";" 4930056";"10113454";" 7491444";" 5467377";" 2622007";" 1610516";"  599578";"  370722";"  172814";"   56042"
"397";"A045844";"2022MM04";"   38824";"   19390";"   19434";" 5140272";" 2472976";" 2667296";" 5140272";" 3944204";" 2831221";" 1196068";"  766679";"  255643";"  154179";"   79609";"   21855"
"398";"A045844";"2022MM05";"   44823";"   22391";"   22432";" 6091195";" 3110099";" 2981096";" 6091195";" 4739981";" 3435213";" 1351212";"  861903";"  295318";"  167706";"  101792";"   25820"
"399";"A045844";"2022MM06";"   43248";"   21627";"   21621";" 6118070";" 3060147";" 3057923";" 6118070";" 4663781";" 3373713";" 1454289";"  938230";"  304849";"  164309";"  112717";"   27823"
"400";"A045844";"2022KW02";"  126895";"   63408";"   63487";"17349537";" 8643222";" 8706315";"17349537";"13347966";" 9640147";" 4001569";" 2566812";"  855810";"  486194";"  294118";"   75498"
"401";"A045844";"2022MM07";"   43218";"   21616";"   21602";" 6211931";" 2960429";" 3251502";" 6211931";" 4597397";" 3335514";" 1614534";"  999352";"  359572";"  197339";"  125850";"   36383"
"402";"A045844";"2022MM08";"   44862";"   22406";"   22456";" 6378969";" 3341249";" 3037720";" 6378969";" 4746288";" 3429215";" 1632678";"  988035";"  368858";"  207584";"  121306";"   39968"
"403";"A045844";"2022MM09";"   43523";"   21769";"   21754";" 6108567";" 3086830";" 3021737";" 6108567";" 4586543";" 3297146";" 1522022";"  929705";"  354897";"  194317";"  117274";"   43306"
"404";"A045844";"2022KW03";"  131603";"   65791";"   65812";"18699467";" 9388508";" 9310959";"18699467";"13930228";"10061875";" 4769234";" 2917092";" 1083327";"  599240";"  364430";"  119657"
"405";"A045844";"2022MM10";"   42909";"   21453";"   21456";" 5854649";" 2970914";" 2883735";" 5854649";" 4349916";" 3095139";" 1504728";"  899342";"  355839";"  196546";"  118928";"   40365"
"406";"A045844";"2022MM11";"   34597";"   17292";"   17305";" 4570458";" 2310665";" 2259793";" 4570458";" 3239466";" 2240055";" 1330990";"  720012";"  371587";"  191074";"  134991";"   45522"
"407";"A045844";"2022MM12";"   34968";"   17489";"   17479";" 4680493";" 2256225";" 2424268";" 4680493";" 3253605";" 2237659";" 1426888";"  770908";"  394191";"  200973";"  141236";"   51982"
"408";"A045844";"2022KW04";"  112474";"   56234";"   56240";"15105600";" 7537804";" 7567796";"15105600";"10842987";" 7572853";" 4262606";" 2390262";" 1121617";"  588593";"  395155";"  137869"
"409";"A045844";"2022JJ00";"  462600";"  231223";"  231377";"61268058";"30752932";"30515126";"61268058";"45612625";"32742252";"15655416";" 9484682";" 3660332";" 2044749";" 1226517";"  389066"
"410";"A045844";"2023MM01";"   34322";"   17149";"   17173";" 4480014";" 2297618";" 2182396";" 4480014";" 3110206";" 2166588";" 1369808";"  720660";"  388095";"  191177";"  138931";"   57987"
"411";"A045844";"2023MM02";"   32416";"   16218";"   16198";" 4348644";" 2141469";" 2207175";" 4348644";" 3107103";" 2169352";" 1241541";"  632782";"  368780";"  180221";"  118650";"   69909"
"412";"A045844";"2023MM03";"   38044";"   19009";"   19035";" 5276851";" 2694481";" 2582370";" 5276851";" 3787923";" 2666828";" 1488926";"  812595";"  417811";"  204809";"  124402";"   88600"
"413";"A045844";"2023KW01";"  104782";"   52376";"   52406";"14105509";" 7133568";" 6971941";"14105509";"10005232";" 7002768";" 4100275";" 2166037";" 1174686";"  576207";"  381983";"  216496"
"414";"A045844";"2023MM04";"   41609";"   20807";"   20802";" 5912774";" 2885106";" 3027668";" 5912774";" 4347203";" 3097485";" 1565569";"  899264";"  448376";"  207767";"  118478";"  122131"
"415";"A045844";"2023MM05";"   45469";"   22718";"   22751";" 6514881";" 3308890";" 3205991";" 6514881";" 4885730";" 3507342";" 1629151";"  937340";"  457094";"  206441";"  128053";"  122600"
"416";"A045844";"2023MM06";"   44638";"   22315";"   22323";" 6539439";" 3267462";" 3271977";" 6539439";" 4855790";" 3490362";" 1683649";"  968591";"  477369";"  210462";"  129750";"  137157"
"417";"A045844";"2023KW02";"  131716";"   65840";"   65876";"18967094";" 9461458";" 9505636";"18967094";"14088723";"10095189";" 4878369";" 2805195";" 1382839";"  624670";"  376281";"  381888"
"418";"A045844";"2023MM07";"   47556";"   23774";"   23782";" 6991247";" 3329949";" 3661298";" 6991247";" 5183615";" 3729439";" 1807616";"  996361";"  536411";"  250588";"  136016";"  149807"
"419";"A045844";"2023MM08";"   48111";"   24034";"   24077";" 7061633";" 3664071";" 3397562";" 7061633";" 5242157";" 3756983";" 1819472";" 1001046";"  532534";"  255141";"  129804";"  147589"
"420";"A045844";"2023MM09";"   47029";"   23508";"   23521";" 6731547";" 3397871";" 3333676";" 6731547";" 5059675";" 3649006";" 1671862";"  935225";"  488381";"  220790";"  126364";"  141227"
"421";"A045844";"2023KW03";"  142696";"   71316";"   71380";"20784427";"10391891";"10392536";"20784427";"15485447";"11135428";" 5298950";" 2932632";" 1557326";"  726519";"  392184";"  438623"
"422";"A045844";"2023MM10";"   47551";"   23779";"   23772";" 6730858";" 3410559";" 3320299";" 6730858";" 5053547";" 3586381";" 1677311";"  935262";"  474117";"  198337";"  132911";"  142869"
"423";"A045844";"2023MM11";"   39272";"   19646";"   19626";" 5315004";" 2681873";" 2633131";" 5315004";" 3860452";" 2648404";" 1454552";"  765465";"  431530";"  167343";"  128986";"  135201"
"424";"A045844";"2023MM12";"   39972";"   19984";"   19988";" 5417945";" 2606793";" 2811152";" 5417945";" 3869937";" 2592579";" 1548006";"  825977";"  462492";"  184547";"  142807";"  135138"
"425";"A045844";"2023KW04";"  126795";"   63409";"   63386";"17463807";" 8699225";" 8764582";"17463807";"12783936";" 8827364";" 4679869";" 2526704";" 1368139";"  550227";"  404704";"  413208"
"426";"A045844";"2023JJ00";"  505989";"  252941";"  253048";"71320837";"35686142";"35634695";"71320837";"52363338";"37060749";"18957463";"10430568";" 5482990";" 2477623";" 1555152";" 1450215"
"427";"A045844";"2024MM01";"   39237";"   19611";"   19626";" 5125828";" 2635086";" 2490742";" 5125828";" 3607769";" 2498712";" 1518059";"  775524";"  479384";"  182973";"  143110";"  153301"
"428";"A045844";"2024MM02";"   39333";"   19652";"   19681";" 5232842";" 2603922";" 2628920";" 5232842";" 3801099";" 2632294";" 1431743";"  698431";"  471431";"  182586";"  135290";"  153555"
"429";"A045844";"2024MM03";"   42859";"   21433";"   21426";" 5891765";" 2967085";" 2924680";" 5891765";" 4299522";" 2997046";" 1592240";"  845283";"  492990";"  183115";"  141691";"  168184"
"430";"A045844";"2024KW01";"  121429";"   60696";"   60733";"16250435";" 8206093";" 8044342";"16250435";"11708390";" 8128052";" 4542042";" 2319238";" 1443805";"  548674";"  420091";"  475040"
"431";"A045844";"2024MM04";"   44627";"   22310";"   22317";" 6274032";" 3060529";" 3213503";" 6274032";" 4687087";" 3351577";" 1586944";"  899811";"  473061";"  178197";"  132235";"  162629"
"432";"A045844";"2024MM05";"   48215";"   24099";"   24116";" 6930388";" 3528268";" 3402120";" 6930388";" 5267580";" 3802255";" 1662804";"  955932";"  477210";"  182112";"  134779";"  160319"
"433";"A045844";"2024MM06";"   46924";"   23462";"   23462";" 6884361";" 3462245";" 3422116";" 6884361";" 5211833";" 3758800";" 1672524";"  958163";"  482710";"  185228";"  132614";"  164868"
"434";"A045844";"2024KW02";"  139766";"   69871";"   69895";"20088781";"10051042";"10037739";"20088781";"15166500";"10912632";" 4922272";" 2813906";" 1432981";"  545537";"  399628";"  487816"
"435";"A045844";"2024MM07";"   48827";"   24421";"   24406";" 7251748";" 3422794";" 3828954";" 7251748";" 5436269";" 3892065";" 1815479";" 1003351";"  534681";"  205513";"  140874";"  188294"
"436";"A045844";"2024MM08";"   49247";"   24604";"   24643";" 7375926";" 3863369";" 3512557";" 7375926";" 5525336";" 3967894";" 1850585";" 1017189";"  542870";"  202159";"  143789";"  196922"
"437";"A045844";"2024MM09";"   47862";"   23930";"   23932";" 6966373";" 3515297";" 3451076";" 6966373";" 5292233";" 3828839";" 1674137";"  924046";"  508147";"  186839";"  136383";"  184925"
"438";"A045844";"2024KW03";"  145936";"   72955";"   72981";"21594047";"10801460";"10792587";"21594047";"16253838";"11688798";" 5340201";" 2944586";" 1585698";"  594511";"  421046";"  570141"
"439";"A045844";"2024MM10";"   47767";"   23879";"   23888";" 6927832";" 3463237";" 3464595";" 6927832";" 5221818";" 3730295";" 1706011";"  932524";"  513326";"  189743";"  142957";"  180626"
"440";"A045844";"2024MM11";"   40629";"   20301";"   20328";" 5657172";" 2897889";" 2759283";" 5657172";" 4117303";" 2836129";" 1539860";"  774442";"  493485";"  184578";"  154933";"  153974"
"441";"A045844";"2024MM12";"   41505";"   20745";"   20760";" 5731674";" 2765647";" 2966027";" 5731674";" 4102568";" 2770238";" 1629102";"  849392";"  497704";"  195577";"  156909";"  145218"
"442";"A045844";"2024KW04";"  129901";"   64925";"   64976";"18316678";" 9126773";" 9189905";"18316678";"13441689";" 9336662";" 4874973";" 2556358";" 1504515";"  569898";"  454799";"  479818"
"443";"A045844";"2024JJ00";"  537032";"  268447";"  268585";"76249941";"38185368";"38064573";"76249941";"56570417";"40066144";"19679488";"10634088";" 5966999";" 2258620";" 1695564";" 2012815"
"444";"A045844";"2025MM01";"   39678";"   19822";"   19856";" 5361172";" 2748722";" 2612450";" 5361172";" 3757594";" 2587965";" 1603578";"  785303";"  528481";"  198036";"  164971";"  165474"
"445";"A045844";"2025MM02";"   38283";"   19135";"   19148";" 5271284";" 2614491";" 2656793";" 5271284";" 3828175";" 2652022";" 1443109";"  684280";"  487498";"  189444";"  151803";"  146251"
"446";"A045844";"2025MM03";"   43579";"   21764";"   21815";" 5998924";" 3061083";" 2937841";" 5998924";" 4415347";" 3102842";" 1583573";"  831904";"  498742";"  180090";"  151083";"  167569"
"447";"A045844";"2025KW01";"  121540";"   60721";"   60819";"16631380";" 8424296";" 8207084";"16631380";"12001116";" 8342829";" 4630260";" 2301487";" 1514721";"  567570";"  467857";"  479294"
"448";"A045844";"2025MM04";"   45927";"   22966";"   22961";" 6671735";" 3254167";" 3417568";" 6671735";" 4979741";" 3567594";" 1691994";"  932417";"  507958";"  192129";"  138376";"  177453"
"449";"A045844";"2025MM05";"   49004";"   24467";"   24537";" 7063336";" 3592597";" 3470739";" 7063336";" 5371241";" 3942311";" 1692077";"  955427";"  495770";"  183269";"  136445";"  176056"
"450";"A045844";"2025MM06";"   46867";"   23406";"   23461";" 6979746";" 3555014";" 3424732";" 6979746";" 5289409";" 3890012";" 1690334";"  975935";"  471172";"  156009";"  137443";"  177720"
"451";"A045844";"2025KW02";"  141798";"   70839";"   70959";"20714817";"10401778";"10313039";"20714817";"15640391";"11399917";" 5074405";" 2863779";" 1474900";"  531407";"  412264";"  531229"
"452";"A045844";"2025MM07";"   49659";"   24830";"   24829";" 7514279";" 3550254";" 3964025";" 7514279";" 5645643";" 4122542";" 1868633";" 1029468";"  555282";"  215462";"  148907";"  190913"
"453";"A045844";"2025MM08";"   50034";"   24990";"   25044";" 7641006";" 4044858";" 3596148";" 7641006";" 5709565";" 4153097";" 1931441";" 1042376";"  585455";"  227935";"  157954";"  199566"
"454";"A043590";"1997JJ00";"  349476";"  174726";"  174750";"31021002";"15496157";"15524845";"31021002";"20282682";"16776756";"10738320";" 6038044";" 3379017";" 1103362";" 1252522";" 1023133"
"455";"A043590";"1998JJ00";"  376810";"  188402";"  188408";"33946104";"16899139";"17046965";"33946104";"22496275";"18667695";"11449829";" 6367845";" 3680895";" 1223619";" 1346148";" 1111128"
"456";"A043590";"1999MM01";"   29640";"   14816";"   14824";" 2372578";" 1192304";" 1180274";" 2372578";" 1496494";" 1256091";"  876084";"  455002";"  298997";"   88737";"  129031";"   81229"
"457";"A043590";"1999MM02";"   27526";"   13760";"   13766";" 2332664";" 1157235";" 1175429";" 2332664";" 1534949";" 1299095";"  797715";"  408987";"  274295";"   82654";"  110775";"   80866"
"458";"A043590";"1999MM03";"   31473";"   15745";"   15728";" 2825328";" 1418232";" 1407096";" 2825328";" 1837844";" 1558660";"  987484";"  531834";"  330139";"  105905";"  120094";"  104140"
"459";"A043590";"1999KW01";"   88639";"   44321";"   44318";" 7530570";" 3767771";" 3762799";" 7530570";" 4869287";" 4113846";" 2661283";" 1395823";"  903431";"  277296";"  359900";"  266235"
"460";"A043590";"1999MM04";"   32013";"   15999";"   16014";" 2901478";" 1430660";" 1470818";" 2901478";" 1926831";" 1636049";"  974647";"  524706";"  331128";"  114182";"  109316";"  107630"
"461";"A043590";"1999MM05";"   34133";"   17070";"   17063";" 3263955";" 1635931";" 1628024";" 3263955";" 2231219";" 1881899";" 1032736";"  588521";"  326257";"  112851";"  105889";"  107517"
"462";"A043590";"1999MM06";"   33426";"   16715";"   16711";" 3226738";" 1595150";" 1631588";" 3226738";" 2179958";" 1819314";" 1046780";"  614953";"  314288";"  106125";"  101899";"  106264"
"463";"A043590";"1999KW02";"   99572";"   49784";"   49788";" 9392171";" 4661741";" 4730430";" 9392171";" 6338008";" 5337262";" 3054163";" 1728180";"  971673";"  333158";"  317104";"  321411"
"464";"A043590";"1999MM07";"   35529";"   17754";"   17775";" 3610786";" 1693176";" 1917610";" 3610786";" 2420422";" 1974481";" 1190364";"  670512";"  365967";"  128138";"  116167";"  121662"
"465";"A043590";"1999MM08";"   35625";"   17818";"   17807";" 3709274";" 1937342";" 1771932";" 3709274";" 2461637";" 2003578";" 1247637";"  692770";"  395456";"  150219";"  123020";"  122217"
"466";"A043590";"1999MM09";"   34411";"   17203";"   17208";" 3467185";" 1742014";" 1725171";" 3467185";" 2340328";" 1964517";" 1126857";"  634140";"  350160";"  121234";"  111050";"  117876"
"467";"A043590";"1999KW03";"  105565";"   52775";"   52790";"10787245";" 5372532";" 5414713";"10787245";" 7222387";" 5942576";" 3564858";" 1997422";" 1111583";"  399591";"  350237";"  361755"
"468";"A043590";"1999MM10";"   35126";"   17566";"   17560";" 3449646";" 1738734";" 1710912";" 3449646";" 2300568";" 1918892";" 1149078";"  628633";"  374954";"  134680";"  122041";"  118233"
"469";"A043590";"1999MM11";"   33182";"   16596";"   16586";" 2802951";" 1415707";" 1387244";" 2802951";" 1819948";" 1534115";"  983003";"  515870";"  335969";"  105347";"  132419";"   98203"
"470";"A043590";"1999MM12";"   31521";"   15799";"   15722";" 2462530";" 1229667";" 1232863";" 2462530";" 1584168";" 1321947";"  878362";"  464360";"  295176";"   92084";"  119712";"   83380"
"471";"A043590";"1999KW04";"   99829";"   49961";"   49868";" 8715127";" 4384108";" 4331019";" 8715127";" 5704684";" 4774954";" 3010443";" 1608863";" 1006099";"  332111";"  374172";"  299816"
"472";"A043590";"1999JJ00";"  393605";"  196841";"  196764";"36425113";"18186152";"18238961";"36425113";"24134366";"20168638";"12290747";" 6730288";" 3992786";" 1342156";" 1401413";" 1249217"
"473";"A043590";"2000MM01";"   32537";"   16229";"   16308";" 2490645";" 1243881";" 1246764";" 2490645";" 1582157";" 1317313";"  908488";"  468432";"  314367";"   91217";"  135072";"   88078"
"474";"A043590";"2000MM02";"   31894";"   15951";"   15943";" 2561520";" 1251605";" 1309915";" 2561520";" 1675373";" 1410946";"  886147";"  444379";"  314424";"   91834";"  130297";"   92293"
"475";"A043590";"2000MM03";"   34263";"   17127";"   17136";" 3067554";" 1557499";" 1510055";" 3067554";" 2017959";" 1687684";" 1049595";"  555392";"  354650";"  114210";"  132135";"  108305"
"476";"A043590";"2000KW01";"   98694";"   49307";"   49387";" 8119719";" 4052985";" 4066734";" 8119719";" 5275489";" 4415943";" 2844230";" 1468203";"  983441";"  297261";"  397504";"  288676"
"477";"A043590";"2000MM04";"   33815";"   16906";"   16909";" 3226951";" 1582875";" 1644076";" 3226951";" 2142676";" 1777869";" 1084275";"  575714";"  371629";"  129843";"  124354";"  117432"
"478";"A043590";"2000MM05";"   36539";"   18276";"   18263";" 3546493";" 1768981";" 1777512";" 3546493";" 2441992";" 2009697";" 1104501";"  623217";"  355685";"  122579";"  113051";"  120055"
"479";"A043590";"2000MM06";"   35206";"   17603";"   17603";" 3492787";" 1748085";" 1744702";" 3492787";" 2373124";" 1923068";" 1119663";"  655471";"  339040";"  110585";"  110128";"  118327"
"480";"A043590";"2000KW02";"  105560";"   52785";"   52775";"10266231";" 5099941";" 5166290";"10266231";" 6957792";" 5710634";" 3308439";" 1854402";" 1066354";"  363007";"  347533";"  355814"
"481";"A043590";"2000MM07";"   37108";"   18553";"   18555";" 3952263";" 1856012";" 2096251";" 3952263";" 2674616";" 2134416";" 1277647";"  714381";"  403142";"  141439";"  125555";"  136148"
"482";"A043590";"2000MM08";"   37258";"   18626";"   18632";" 3932072";" 2060959";" 1871113";" 3932072";" 2648907";" 2110330";" 1283165";"  702802";"  409908";"  150100";"  127893";"  131915"
"483";"A043590";"2000MM09";"   35496";"   17752";"   17744";" 3720284";" 1857698";" 1862586";" 3720284";" 2533364";" 2065190";" 1186920";"  650945";"  380381";"  126136";"  121304";"  132941"
"484";"A043590";"2000KW03";"  109862";"   54931";"   54931";"11604619";" 5774669";" 5829950";"11604619";" 7856887";" 6309936";" 3747732";" 2068128";" 1193431";"  417675";"  374752";"  401004"
"485";"A043590";"2000MM10";"   36170";"   18087";"   18083";" 3651555";" 1857661";" 1793894";" 3651555";" 2475461";" 2014934";" 1176094";"  620993";"  394934";"  129359";"  132597";"  132978"
"486";"A043590";"2000MM11";"   32902";"   16455";"   16447";" 2914972";" 1467988";" 1446984";" 2914972";" 1901315";" 1581188";" 1013657";"  521696";"  348726";"   96316";"  142380";"  110030"
"487";"A043590";"2000MM12";"   31739";"   15874";"   15865";" 2713514";" 1326896";" 1386618";" 2713514";" 1731137";" 1431939";"  982377";"  505127";"  338342";"   92897";"  140959";"  104486"
"488";"A043590";"2000KW04";"  100811";"   50416";"   50395";" 9280041";" 4652545";" 4627496";" 9280041";" 6107913";" 5028061";" 3172128";" 1647816";" 1082002";"  318572";"  415936";"  347494"
"489";"A043590";"2000JJ00";"  414927";"  207439";"  207488";"39270610";"19580140";"19690470";"39270610";"26198081";"21464574";"13072529";" 7038549";" 4325228";" 1396515";" 1535725";" 1392988"
"490";"A043590";"2001MM01";"   32835";"   16416";"   16419";" 2703997";" 1372944";" 1331053";" 2703997";" 1706476";" 1418968";"  997521";"  495888";"  353274";"   93247";"  156379";"  103648"
"491";"A043590";"2001MM02";"   30436";"   15219";"   15217";" 2591373";" 1267878";" 1323495";" 2591373";" 1698103";" 1417395";"  893270";"  432925";"  324347";"   88845";"  139103";"   96399"
"492";"A043590";"2001MM03";"   34529";"   17261";"   17268";" 3163748";" 1606317";" 1557431";" 3163748";" 2078101";" 1710801";" 1085647";"  554418";"  380875";"  118069";"  144062";"  118744"
"493";"A043590";"2001KW01";"   97800";"   48896";"   48904";" 8459118";" 4247139";" 4211979";" 8459118";" 5482680";" 4547164";" 2976438";" 1483231";" 1058496";"  300161";"  439544";"  318791"
"494";"A043590";"2001MM04";"   34151";"   17081";"   17070";" 3355137";" 1653479";" 1701658";" 3355137";" 2243954";" 1845993";" 1111183";"  598527";"  376253";"  126038";"  135299";"  114916"
"495";"A043590";"2001MM05";"   37255";"   18622";"   18633";" 3613702";" 1802284";" 1811418";" 3613702";" 2516386";" 2018074";" 1097316";"  618800";"  355051";"  118043";"  122319";"  114689"
"496";"A043590";"2001MM06";"   36209";"   18100";"   18109";" 3686773";" 1840121";" 1846652";" 3686773";" 2519289";" 2020261";" 1167484";"  660362";"  370608";"  120532";"  125574";"  124502"
"497";"A043590";"2001KW02";"  107615";"   53803";"   53812";"10655612";" 5295884";" 5359728";"10655612";" 7279629";" 5884328";" 3375983";" 1877689";" 1101912";"  364613";"  383192";"  354107"
"498";"A043590";"2001MM07";"   38386";"   19193";"   19193";" 4098716";" 1931531";" 2167185";" 4098716";" 2804259";" 2207429";" 1294457";"  691505";"  440060";"  161025";"  145447";"  133588"
"499";"A043590";"2001MM08";"   38451";"   19223";"   19228";" 4063517";" 2133641";" 1929876";" 4063517";" 2749663";" 2183373";" 1313854";"  689852";"  454987";"  176035";"  144805";"  134147"
"500";"A043590";"2001MM09";"   36432";"   18219";"   18213";" 3551489";" 1776240";" 1775249";" 3551489";" 2494721";" 1990813";" 1056768";"  537573";"  372614";"  120716";"  126840";"  125058"
"501";"A043590";"2001KW03";"  113269";"   56635";"   56634";"11713722";" 5841412";" 5872310";"11713722";" 8048643";" 6381615";" 3665079";" 1918930";" 1267661";"  457776";"  417092";"  392793"
"502";"A043590";"2001MM10";"   36486";"   18244";"   18242";" 3226663";" 1643771";" 1582892";" 3226663";" 2290737";" 1839589";"  935926";"  465976";"  325914";"  102208";"  119984";"  103722"
"503";"A043590";"2001MM11";"   31059";"   15532";"   15527";" 2656842";" 1334350";" 1322492";" 2656842";" 1831133";" 1535292";"  825709";"  419974";"  286184";"   75795";"  121009";"   89380"
"504";"A043590";"2001MM12";"   30227";"   15114";"   15113";" 2597484";" 1266484";" 1331000";" 2597484";" 1710139";" 1421090";"  887345";"  453844";"  306969";"   88131";"  125785";"   93053"
"505";"A043590";"2001KW04";"   97772";"   48890";"   48882";" 8480989";" 4244605";" 4236384";" 8480989";" 5832009";" 4795971";" 2648980";" 1339794";"  919067";"  266134";"  366778";"  286155"
"506";"A043590";"2001JJ00";"  416456";"  208224";"  208232";"39309441";"19629040";"19680401";"39309441";"26642961";"21609078";"12666480";" 6619644";" 4347136";" 1388684";" 1606606";" 1351846"
"507";"A043590";"2002MM01";"   30835";"   15409";"   15426";" 2572399";" 1304963";" 1267436";" 2572399";" 1658347";" 1385422";"  914052";"  448415";"  326813";"   86132";"  140592";"  100089"
"508";"A043590";"2002MM02";"   28453";"   14229";"   14224";" 2596631";" 1278061";" 1318570";" 2596631";" 1755008";" 1473719";"  841623";"  402249";"  303846";"   83976";"  126986";"   92884"
"509";"A043590";"2002MM03";"   32365";"   16175";"   16190";" 3165225";" 1592617";" 1572608";" 3165225";" 2127732";" 1765422";" 1037493";"  518028";"  362137";"  107118";"  136231";"  118788"
"510";"A043590";"2002KW01";"   91653";"   45813";"   45840";" 8334255";" 4175641";" 4158614";" 8334255";" 5541087";" 4624563";" 2793168";" 1368692";"  992796";"  277226";"  403809";"  311761"
"511";"A043590";"2002MM04";"   33107";"   16558";"   16549";" 3303145";" 1601630";" 1701515";" 3303145";" 2312401";" 1880116";"  990744";"  507066";"  347607";"  107360";"  123931";"  116316"
"512";"A043590";"2002MM05";"   35599";"   17795";"   17804";" 3698247";" 1874934";" 1823313";" 3698247";" 2658970";" 2101262";" 1039277";"  563262";"  348073";"  109342";"  120597";"  118134"
"513";"A043590";"2002MM06";"   34519";"   17257";"   17262";" 3668631";" 1808523";" 1860108";" 3668631";" 2561913";" 2029698";" 1106718";"  608582";"  359917";"  116337";"  118960";"  124620"
"514";"A043590";"2002KW02";"  103225";"   51610";"   51615";"10670023";" 5285087";" 5384936";"10670023";" 7533284";" 6011076";" 3136739";" 1678910";" 1055597";"  333039";"  363488";"  359070"
"515";"A043590";"2002MM07";"   36973";"   18489";"   18484";" 4130433";" 1965535";" 2164898";" 4130433";" 2897866";" 2239649";" 1232567";"  656689";"  406728";"  147451";"  132312";"  126965"
"516";"A043590";"2002MM08";"   36840";"   18419";"   18421";" 4131400";" 2161757";" 1969643";" 4131400";" 2863699";" 2229055";" 1267701";"  665832";"  427248";"  162856";"  132314";"  132078"
"517";"A043590";"2002MM09";"   35111";"   17560";"   17551";" 3864358";" 1922853";" 1941505";" 3864358";" 2717046";" 2156418";" 1147312";"  605003";"  380321";"  124270";"  125131";"  130920"
"518";"A043590";"2002KW03";"  108924";"   54468";"   54456";"12126191";" 6050145";" 6076046";"12126191";" 8478611";" 6625122";" 3647580";" 1927524";" 1214297";"  434577";"  389757";"  389963"
"519";"A043590";"2002MM10";"   35663";"   17830";"   17833";" 3721110";" 1890032";" 1831078";" 3721110";" 2599838";" 2040262";" 1121272";"  584454";"  368414";"  114685";"  129357";"  124372"
"520";"A043590";"2002MM11";"   31670";"   15836";"   15834";" 2892532";" 1455318";" 1437214";" 2892532";" 1932027";" 1601991";"  960505";"  493734";"  323790";"   88766";"  125171";"  109853"
"521";"A043590";"2002MM12";"   30250";"   15136";"   15114";" 2843451";" 1385381";" 1458070";" 2843451";" 1836464";" 1515717";" 1006987";"  528920";"  330373";"  101238";"  126132";"  103003"
"522";"A043590";"2002KW04";"   97583";"   48802";"   48781";" 9457093";" 4730731";" 4726362";" 9457093";" 6368329";" 5157970";" 3088764";" 1607108";" 1022577";"  304689";"  380660";"  337228"
"523";"A043590";"2002JJ00";"  401385";"  200693";"  200692";"40587562";"20241604";"20345958";"40587562";"27921311";"22418731";"12666251";" 6582234";" 4285267";" 1349531";" 1537714";" 1398022"
"524";"A043590";"2003MM01";"   30549";"   15257";"   15292";" 2747502";" 1394786";" 1352716";" 2747502";" 1754994";" 1456223";"  992508";"  497324";"  344905";"   97017";"  141969";"  105919"
"525";"A043590";"2003MM02";"   28780";"   14392";"   14388";" 2668775";" 1310574";" 1358201";" 2668775";" 1794268";" 1499185";"  874507";"  430647";"  301449";"   78301";"  125163";"   97985"
"526";"A043590";"2003MM03";"   32562";"   16288";"   16274";" 3018602";" 1535286";" 1483316";" 3018602";" 2071769";" 1719513";"  946833";"  502530";"  304356";"   72245";"  123682";"  108429"
"527";"A043590";"2003KW01";"   91891";"   45937";"   45954";" 8434879";" 4240646";" 4194233";" 8434879";" 5621031";" 4674921";" 2813848";" 1430501";"  950710";"  247563";"  390814";"  312333"
"528";"A043590";"2003MM04";"   31560";"   15786";"   15774";" 3013392";" 1455492";" 1557900";" 3013392";" 2156829";" 1773195";"  856563";"  482273";"  251322";"   67458";"  107236";"   76628"
"529";"A043590";"2003MM05";"   33896";"   16928";"   16968";" 3393657";" 1704497";" 1689160";" 3393657";" 2490478";" 1989496";"  903179";"  532927";"  250708";"   91223";"   98317";"   61168"
"530";"A043590";"2003MM06";"   33511";"   16765";"   16746";" 3544233";" 1745817";" 1798416";" 3544233";" 2548756";" 2012930";"  995477";"  582663";"  287188";"  102463";"  108755";"   75970"
"531";"A043590";"2003KW02";"   98967";"   49479";"   49488";" 9951282";" 4905806";" 5045476";" 9951282";" 7196063";" 5775621";" 2755219";" 1597863";"  789218";"  261144";"  314308";"  213766"
"532";"A043590";"2003MM07";"   36036";"   18012";"   18024";" 4075832";" 1933355";" 2142477";" 4075832";" 2886991";" 2198323";" 1188841";"  656145";"  370119";"  135418";"  135619";"   99082"
"533";"A043590";"2003MM08";"   35722";"   17863";"   17859";" 4032923";" 2130647";" 1902276";" 4032923";" 2797706";" 2152493";" 1235217";"  651163";"  411572";"  150506";"  135336";"  125730"
"534";"A043590";"2003MM09";"   34508";"   17253";"   17255";" 3734509";" 1852305";" 1882204";" 3734509";" 2628432";" 2060094";" 1106077";"  585688";"  364218";"  115434";"  118291";"  130493"
"535";"A043590";"2003KW03";"  106266";"   53128";"   53138";"11843264";" 5916307";" 5926957";"11843264";" 8313129";" 6410910";" 3530135";" 1892996";" 1145909";"  401358";"  389246";"  355305"
"536";"A043590";"2003MM10";"   35108";"   17551";"   17557";" 3761285";" 1908245";" 1853040";" 3761285";" 2631320";" 2040890";" 1129965";"  583304";"  377910";"  119958";"  127331";"  130621"
"537";"A043590";"2003MM11";"   31054";"   15531";"   15523";" 2970090";" 1489005";" 1481085";" 2970090";" 1980956";" 1613544";"  989134";"  510367";"  330588";"   91866";"  127464";"  111258"
"538";"A043590";"2003MM12";"   29710";"   14886";"   14824";" 2847849";" 1389921";" 1457928";" 2847849";" 1835351";" 1491893";" 1012498";"  524144";"  334043";"  102219";"  131792";"  100032"
"539";"A043590";"2003KW04";"   95872";"   47968";"   47904";" 9579224";" 4787171";" 4792053";" 9579224";" 6447627";" 5146327";" 3131597";" 1617815";" 1042541";"  314043";"  386587";"  341911"
"540";"A043590";"2003JJ00";"  392996";"  196512";"  196484";"39808649";"19849930";"19958719";"39808649";"27577850";"22007779";"12230799";" 6539175";" 3928378";" 1224108";" 1480955";" 1223315"
"541";"A043590";"2004MM01";"   29762";"   14849";"   14913";" 2741680";" 1386421";" 1355259";" 2741680";" 1712817";" 1394292";" 1028863";"  511108";"  350952";"  100198";"  146496";"  104258"
"542";"A043590";"2004MM02";"   29361";"   14681";"   14680";" 2830639";" 1394302";" 1436337";" 2830639";" 1871583";" 1532901";"  959056";"  461663";"  333041";"   93775";"  133151";"  106115"
"543";"A043590";"2004MM03";"   32726";"   16366";"   16360";" 3257673";" 1656357";" 1601316";" 3257673";" 2172871";" 1774559";" 1084802";"  552050";"  363591";"  108120";"  134139";"  121332"
"544";"A043590";"2004KW01";"   91849";"   45896";"   45953";" 8829992";" 4437080";" 4392912";" 8829992";" 5757271";" 4701752";" 3072721";" 1524821";" 1047584";"  302093";"  413786";"  331705"
"545";"A043590";"2004MM04";"   32678";"   16335";"   16343";" 3480085";" 1693564";" 1786521";" 3480085";" 2380283";" 1902359";" 1099802";"  580724";"  369215";"  119625";"  123333";"  126257"
"546";"A043590";"2004MM05";"   35697";"   17851";"   17846";" 3843271";" 1932881";" 1910390";" 3843271";" 2729841";" 2091874";" 1113430";"  615433";"  360457";"  114456";"  118529";"  127472"
"547";"A043590";"2004MM06";"   34865";"   17426";"   17439";" 3796961";" 1893565";" 1903396";" 3796961";" 2662991";" 2073742";" 1133970";"  623784";"  374018";"  118316";"  121015";"  134687"
"548";"A043590";"2004KW02";"  103240";"   51612";"   51628";"11120317";" 5520010";" 5600307";"11120317";" 7773115";" 6067975";" 3347202";" 1819941";" 1103690";"  352397";"  362877";"  388416"
"549";"A043590";"2004MM07";"   36912";"   18449";"   18463";" 4337767";" 2033995";" 2303772";" 4337767";" 3039462";" 2253947";" 1298305";"  679539";"  431727";"  141364";"  143510";"  146853"
"550";"A043590";"2004MM08";"   36696";"   18353";"   18343";" 4243630";" 2223513";" 2020117";" 4243630";" 2935092";" 2222331";" 1308538";"  677807";"  438630";"  150597";"  141111";"  146922"
"551";"A043590";"2004MM09";"   35330";"   17671";"   17659";" 3927202";" 1954521";" 1972681";" 3927202";" 2731010";" 2109650";" 1196192";"  624841";"  393974";"  118199";"  124670";"  151105"
"552";"A043590";"2004KW03";"  108938";"   54473";"   54465";"12508599";" 6212029";" 6296570";"12508599";" 8705564";" 6585928";" 3803035";" 1982187";" 1264331";"  410160";"  409291";"  444880"
"553";"A043590";"2004MM10";"   36481";"   18242";"   18239";" 3915296";" 1979928";" 1935368";" 3915296";" 2714635";" 2053667";" 1200661";"  613923";"  400810";"  116294";"  132466";"  152050"
"554";"A043590";"2004MM11";"   31646";"   15828";"   15818";" 3087396";" 1545102";" 1542294";" 3087396";" 2017426";" 1625522";" 1069970";"  532964";"  370550";"   92920";"  146895";"  130735"
"555";"A043590";"2004MM12";"   30584";"   15319";"   15265";" 2963792";" 1445136";" 1518656";" 2963792";" 1866050";" 1500622";" 1097742";"  556277";"  372860";"  102584";"  152514";"  117762"
"556";"A043590";"2004KW04";"   98711";"   49389";"   49322";" 9966484";" 4970166";" 4996318";" 9966484";" 6598111";" 5179811";" 3368373";" 1703164";" 1144220";"  311798";"  431875";"  400547"
"557";"A043590";"2004JJ00";"  402738";"  201370";"  201368";"42425392";"21139285";"21286107";"42425392";"28834061";"22535466";"13591331";" 7030113";" 4559825";" 1376448";" 1617829";" 1565548"
"558";"A043590";"2005MM01";"   30353";"   15147";"   15206";" 2955792";" 1488217";" 1467575";" 2955792";" 1826971";" 1544187";" 1128821";"  555620";"  391734";"   93044";"  173174";"  125516"
"559";"A043590";"2005MM02";"   28579";"   14289";"   14290";" 2829925";" 1407350";" 1422575";" 2829925";" 1829433";" 1562169";" 1000492";"  486368";"  343764";"   81494";"  146612";"  115658"
"560";"A043590";"2005MM03";"   31827";"   15912";"   15915";" 3281195";" 1646577";" 1634618";" 3281195";" 2137360";" 1817173";" 1143835";"  578847";"  376819";"   97613";"  145925";"  133281"
"561";"A043590";"2005KW01";"   90759";"   45348";"   45411";" 9066912";" 4542144";" 4524768";" 9066912";" 5793764";" 4923529";" 3273148";" 1620835";" 1112317";"  272151";"  465711";"  374455"
"562";"A043590";"2005MM04";"   33739";"   16862";"   16877";" 3548011";" 1735488";" 1812523";" 3548011";" 2388567";" 2000129";" 1159444";"  595823";"  391362";"  105003";"  141301";"  145058"
"563";"A043590";"2005MM05";"   36673";"   18344";"   18329";" 4059648";" 2027863";" 2031785";" 4059648";" 2867159";" 2278939";" 1192489";"  645783";"  379714";"  105519";"  129437";"  144758"
"564";"A043590";"2005MM06";"   35239";"   17622";"   17617";" 3941175";" 1952478";" 1988697";" 3941175";" 2724670";" 2223836";" 1216505";"  663236";"  386949";"  105792";"  131961";"  149196"
"565";"A043590";"2005KW02";"  105651";"   52828";"   52823";"11548834";" 5715829";" 5833005";"11548834";" 7980396";" 6502904";" 3568438";" 1904842";" 1158025";"  316314";"  402699";"  439012"
"566";"A043590";"2005MM07";"   37256";"   18620";"   18636";" 4528594";" 2122109";" 2406485";" 4528594";" 3134037";" 2450487";" 1394557";"  731989";"  445891";"  130270";"  154843";"  160778"
"567";"A043590";"2005MM08";"   37282";"   18647";"   18635";" 4433151";" 2319924";" 2113227";" 4433151";" 3050034";" 2418509";" 1383117";"  719438";"  443631";"  132309";"  152567";"  158755"
"568";"A043590";"2005MM09";"   35712";"   17861";"   17851";" 4145737";" 2069173";" 2076564";" 4145737";" 2875493";" 2361466";" 1270244";"  659116";"  416169";"  109975";"  143016";"  163178"
"569";"A043590";"2005KW03";"  110250";"   55128";"   55122";"13107482";" 6511206";" 6596276";"13107482";" 9059564";" 7230462";" 4047918";" 2110543";" 1305691";"  372554";"  450426";"  482711"
"570";"A043590";"2005MM10";"   36321";"   18166";"   18155";" 4077132";" 2064136";" 2012996";" 4077132";" 2848214";" 2291154";" 1228918";"  627559";"  403631";"   99092";"  148304";"  156235"
"571";"A043590";"2005MM11";"   31482";"   15736";"   15746";" 3198519";" 1594271";" 1604248";" 3198519";" 2097811";" 1802558";" 1100708";"  535889";"  385763";"   96394";"  151088";"  138281"
"572";"A043590";"2005MM12";"   30131";"   15089";"   15042";" 3078660";" 1499625";" 1579035";" 3078660";" 1966719";" 1682176";" 1111941";"  546925";"  383514";"  102483";"  157100";"  123931"
"573";"A043590";"2005KW04";"   97934";"   48991";"   48943";"10354311";" 5158032";" 5196279";"10354311";" 6912744";" 5775888";" 3441567";" 1710373";" 1172908";"  297969";"  456492";"  418447"
"574";"A043590";"2005JJ00";"  404594";"  202295";"  202299";"44077539";"21927211";"22150328";"44077539";"29746468";"24432783";"14331071";" 7346593";" 4748941";" 1258988";" 1775328";" 1714625"
"575";"A043590";"2006MM01";"   30299";"   15130";"   15169";" 3028207";" 1529682";" 1498525";" 3028207";" 1887313";" 1603742";" 1140894";"  544084";"  403131";"   96590";"  177102";"  129439"
"576";"A043590";"2006MM02";"   28403";"   14201";"   14202";" 2858444";" 1408888";" 1449556";" 2858444";" 1864229";" 1605571";"  994215";"  458786";"  361632";"   81566";"  157869";"  122197"
"577";"A043590";"2006MM03";"   33044";"   16522";"   16522";" 3399315";" 1715453";" 1683862";" 3399315";" 2226476";" 1910755";" 1172839";"  570315";"  413326";"  103862";"  163665";"  145799"
"578";"A043590";"2006KW01";"   91746";"   45853";"   45893";" 9285966";" 4654023";" 4631943";" 9285966";" 5978018";" 5120068";" 3307948";" 1573185";" 1178089";"  282018";"  498636";"  397435"
"579";"A043590";"2006MM04";"   34698";"   17345";"   17353";" 3808994";" 1861980";" 1947014";" 3808994";" 2588631";" 2202036";" 1220363";"  609319";"  427319";"  116177";"  160960";"  150182"
"580";"A043590";"2006MM05";"   38146";"   19075";"   19071";" 4176097";" 2091783";" 2084314";" 4176097";" 2962123";" 2470933";" 1213974";"  636673";"  404352";"  102963";"  149916";"  151473"
"581";"A043590";"2006MM06";"   37526";"   18761";"   18765";" 4228327";" 2110234";" 2118093";" 4228327";" 2965843";" 2479775";" 1262484";"  663559";"  420297";"  111953";"  154966";"  153378"
"582";"A043590";"2006KW02";"  110370";"   55181";"   55189";"12213418";" 6063997";" 6149421";"12213418";" 8516597";" 7152744";" 3696821";" 1909551";" 1251968";"  331093";"  465842";"  455033"
"583";"A043590";"2006MM07";"   39290";"   19649";"   19641";" 4744439";" 2219591";" 2524848";" 4744439";" 3331417";" 2696275";" 1413022";"  710651";"  461931";"  129971";"  169610";"  162350"
"584";"A043590";"2006MM08";"   39036";"   19516";"   19520";" 4608170";" 2417135";" 2191035";" 4608170";" 3198583";" 2585910";" 1409587";"  695525";"  467162";"  136930";"  165451";"  164781"
"585";"A043590";"2006MM09";"   37521";"   18760";"   18761";" 4295374";" 2151366";" 2144008";" 4295374";" 3002208";" 2508833";" 1293166";"  650258";"  433163";"  102557";"  158376";"  172230"
"586";"A043590";"2006KW03";"  115847";"   57925";"   57922";"13647983";" 6788092";" 6859891";"13647983";" 9532208";" 7791018";" 4115775";" 2056434";" 1362256";"  369458";"  493437";"  499361"
"587";"A043590";"2006MM10";"   38413";"   19212";"   19201";" 4201473";" 2118890";" 2082583";" 4201473";" 2921557";" 2430627";" 1279916";"  635102";"  430348";"   97587";"  163162";"  169599"
"588";"A043590";"2006MM11";"   34346";"   17187";"   17159";" 3353275";" 1683436";" 1669839";" 3353275";" 2229054";" 1917284";" 1124221";"  541302";"  391984";"   85526";"  160249";"  146209"
"589";"A043590";"2006MM12";"   32400";"   16216";"   16184";" 3286851";" 1598572";" 1688279";" 3286851";" 2109827";" 1797342";" 1177024";"  579243";"  399460";"   96980";"  168906";"  133574"
"590";"A043590";"2006KW04";"  105159";"   52615";"   52544";"10841599";" 5400898";" 5440701";"10841599";" 7260438";" 6145253";" 3581161";" 1755647";" 1221792";"  280093";"  492317";"  449382"
"591";"A043590";"2006JJ00";"  423122";"  211574";"  211548";"45988966";"22907010";"23081956";"45988966";"31287261";"26209083";"14701705";" 7294817";" 5014105";" 1262662";" 1950232";" 1801211"
"592";"A043590";"2007MM01";"   32686";"   16326";"   16360";" 3169889";" 1615134";" 1554755";" 3169889";" 1993371";" 1717250";" 1176518";"  563084";"  412674";"   92990";"  185303";"  134381"
"593";"A043590";"2007MM02";"   30915";"   15458";"   15457";" 3051720";" 1504093";" 1547627";" 3051720";" 2014433";" 1739752";" 1037287";"  483069";"  371367";"   78374";"  163181";"  129812"
"594";"A043590";"2007MM03";"   35459";"   17730";"   17729";" 3695426";" 1874996";" 1820430";" 3695426";" 2465479";" 2126631";" 1229947";"  597245";"  425611";"   97588";"  170141";"  157882"
"595";"A043590";"2007KW01";"   99060";"   49514";"   49546";" 9917035";" 4994223";" 4922812";" 9917035";" 6473283";" 5583633";" 3443752";" 1643398";" 1209652";"  268952";"  518625";"  422075"
"596";"A043590";"2007MM04";"   36079";"   18042";"   18037";" 3905501";" 1914054";" 1991447";" 3905501";" 2685778";" 2303151";" 1219723";"  613710";"  424079";"  105707";"  157905";"  160467"
"597";"A043590";"2007MM05";"   39509";"   19749";"   19760";" 4296458";" 2160655";" 2135803";" 4296458";" 3050454";" 2546505";" 1246004";"  660927";"  406831";"  101127";"  144737";"  160967"
"598";"A043590";"2007MM06";"   38054";"   19025";"   19029";" 4246247";" 2114293";" 2131954";" 4246247";" 2960451";" 2483605";" 1285796";"  674787";"  424740";"  104531";"  153622";"  166587"
"599";"A043590";"2007KW02";"  113642";"   56816";"   56826";"12448206";" 6189002";" 6259204";"12448206";" 8696683";" 7333261";" 3751523";" 1949424";" 1255650";"  311365";"  456264";"  488021"
"600";"A043590";"2007MM07";"   40464";"   20230";"   20234";" 4921849";" 2307792";" 2614057";" 4921849";" 3459722";" 2851437";" 1462127";"  740303";"  467095";"  124426";"  169346";"  173323"
"601";"A043590";"2007MM08";"   40136";"   20070";"   20066";" 4821446";" 2543312";" 2278134";" 4821446";" 3350716";" 2778350";" 1470730";"  739100";"  475661";"  136961";"  163187";"  175513"
"602";"A043590";"2007MM09";"   37832";"   18911";"   18921";" 4425064";" 2211075";" 2213989";" 4425064";" 3086664";" 2594591";" 1338400";"  689846";"  432203";"   97825";"  154270";"  180108"
"603";"A043590";"2007KW03";"  118432";"   59211";"   59221";"14168359";" 7062179";" 7106180";"14168359";" 9897102";" 8224378";" 4271257";" 2169249";" 1374959";"  359212";"  486803";"  528944"
"604";"A043590";"2007MM10";"   38653";"   19331";"   19322";" 4379099";" 2213959";" 2165140";" 4379099";" 3027094";" 2529826";" 1352005";"  677302";"  449193";"  106027";"  162681";"  180485"
"605";"A043590";"2007MM11";"   33886";"   16945";"   16941";" 3472889";" 1745839";" 1727050";" 3472889";" 2288084";" 1974688";" 1184805";"  570558";"  412065";"   93479";"  168019";"  150567"
"606";"A043590";"2007MM12";"   32299";"   16170";"   16129";" 3359160";" 1644613";" 1714547";" 3359160";" 2134644";" 1835956";" 1224516";"  600910";"  417600";"  107197";"  173206";"  137197"
"607";"A043590";"2007KW04";"  104838";"   52446";"   52392";"11211148";" 5604411";" 5606737";"11211148";" 7449822";" 6340470";" 3761326";" 1848770";" 1278858";"  306703";"  503906";"  468249"
"608";"A043590";"2007JJ00";"  435972";"  217987";"  217985";"47744748";"23849815";"23894933";"47744748";"32516890";"27481742";"15227858";" 7610841";" 5119119";" 1246232";" 1965598";" 1907289"
"609";"A043590";"2008MM01";"   32519";"   16224";"   16295";" 3200944";" 1625090";" 1575854";" 3200944";" 2002811";" 1710942";" 1198133";"  571163";"  425628";"   94755";"  188743";"  142130"
"610";"A043590";"2008MM02";"   31213";"   15608";"   15605";" 3153170";" 1559515";" 1593655";" 3153170";" 2070274";" 1778962";" 1082896";"  504413";"  390617";"   85586";"  174493";"  130538"
"611";"A043590";"2008MM03";"   34207";"   17099";"   17108";" 3741498";" 1891982";" 1849516";" 3741498";" 2458467";" 2104504";" 1283031";"  618652";"  453843";"  110469";"  182250";"  161124"
"612";"A043590";"2008KW01";"   97939";"   48931";"   49008";"10095612";" 5076587";" 5019025";"10095612";" 6531552";" 5594408";" 3564060";" 1694228";" 1270088";"  290810";"  545486";"  433792"
"613";"A043590";"2008MM04";"   36218";"   18105";"   18113";" 3918719";" 1878915";" 2039804";" 3918719";" 2647271";" 2234222";" 1271448";"  641464";"  440503";"  109717";"  165132";"  165654"
"614";"A043590";"2008MM05";"   39172";"   19583";"   19589";" 4403449";" 2260285";" 2143164";" 4403449";" 3063829";" 2538621";" 1339620";"  719165";"  425123";"  106876";"  158805";"  159442"
"615";"A043590";"2008MM06";"   38202";"   19103";"   19099";" 4400407";" 2163721";" 2236686";" 4400407";" 3029210";" 2515360";" 1371197";"  734132";"  431015";"  110894";"  160510";"  159611"
"616";"A043590";"2008KW02";"  113592";"   56791";"   56801";"12722575";" 6302921";" 6419654";"12722575";" 8740310";" 7288203";" 3982265";" 2094761";" 1296641";"  327487";"  484447";"  484707"
"617";"A043590";"2008MM07";"   39759";"   19869";"   19890";" 4847473";" 2321201";" 2526272";" 4847473";" 3328794";" 2727241";" 1518679";"  785198";"  474816";"  128560";"  177135";"  169121"
"618";"A043590";"2008MM08";"   39114";"   19554";"   19560";" 4716136";" 2490123";" 2226013";" 4716136";" 3197701";" 2635950";" 1518435";"  789682";"  476732";"  133740";"  172954";"  170038"
"619";"A043590";"2008MM09";"   37471";"   18742";"   18729";" 4297440";" 2151099";" 2146341";" 4297440";" 2957380";" 2468714";" 1340060";"  714221";"  417676";"   97559";"  156745";"  163372"
"620";"A043590";"2008KW03";"  116344";"   58165";"   58179";"13861049";" 6962423";" 6898626";"13861049";" 9483875";" 7831905";" 4377174";" 2289101";" 1369224";"  359859";"  506834";"  502531"
"621";"A043590";"2008MM10";"   38090";"   19045";"   19045";" 4272253";" 2159699";" 2112554";" 4272253";" 2886507";" 2387028";" 1385746";"  701390";"  449201";"  111931";"  165621";"  171649"
"622";"A043590";"2008MM11";"   32029";"   16014";"   16015";" 3271834";" 1648293";" 1623541";" 3271834";" 2109255";" 1804169";" 1162579";"  554525";"  401745";"   96648";"  160428";"  144669"
"623";"A043590";"2008MM12";"   30338";"   15191";"   15147";" 3168388";" 1553743";" 1614645";" 3168388";" 1973801";" 1681497";" 1194587";"  588793";"  401079";"  102200";"  166126";"  132753"
"624";"A043590";"2008KW04";"  100457";"   50250";"   50207";"10712475";" 5361735";" 5350740";"10712475";" 6969563";" 5872694";" 3742912";" 1844708";" 1252025";"  310779";"  492175";"  449071"
"625";"A043590";"2008JJ00";"  428332";"  214137";"  214195";"47391711";"23703666";"23688045";"47391711";"31725300";"26587210";"15666411";" 7922798";" 5187978";" 1288935";" 2028942";" 1870101"
"626";"A043590";"2009MM01";"   29843";"   14886";"   14957";" 2911748";" 1484402";" 1427346";" 2911748";" 1770284";" 1499898";" 1141464";"  545365";"  398487";"   89904";"  175958";"  132625"
"627";"A043590";"2009MM02";"   27555";"   13775";"   13780";" 2720999";" 1349352";" 1371647";" 2720999";" 1761430";" 1497953";"  959569";"  432998";"  343724";"   76367";"  145826";"  121531"
"628";"A043590";"2009MM03";"   31503";"   15757";"   15746";" 3199918";" 1623572";" 1576346";" 3199918";" 2085984";" 1777124";" 1113934";"  532118";"  386576";"   95076";"  151166";"  140334"
"629";"A043590";"2009KW01";"   88901";"   44418";"   44483";" 8832665";" 4457326";" 4375339";" 8832665";" 5617698";" 4774975";" 3214967";" 1510481";" 1128787";"  261347";"  472950";"  394490"
"630";"A043590";"2009MM04";"   33256";"   16629";"   16627";" 3672623";" 1788469";" 1884154";" 3672623";" 2463559";" 2062549";" 1209064";"  600938";"  414098";"  112737";"  144963";"  156398"
"631";"A043590";"2009MM05";"   35264";"   17631";"   17633";" 3892013";" 1982098";" 1909915";" 3892013";" 2705907";" 2234094";" 1186106";"  624908";"  371702";"   96909";"  132997";"  141796"
"632";"A043590";"2009MM06";"   34308";"   17152";"   17156";" 3850845";" 1934577";" 1916268";" 3850845";" 2639673";" 2182500";" 1211172";"  648069";"  369601";"  100589";"  133087";"  135925"
"633";"A043590";"2009KW02";"  102828";"   51412";"   51416";"11415481";" 5705144";" 5710337";"11415481";" 7809139";" 6479143";" 3606342";" 1873915";" 1155401";"  310235";"  411047";"  434119"
"634";"A043590";"2009MM07";"   36666";"   18323";"   18343";" 4532467";" 2130115";" 2402352";" 4532467";" 3109369";" 2541454";" 1423098";"  709298";"  451368";"  126624";"  155626";"  169118"
"635";"A043590";"2009MM08";"   36372";"   18193";"   18179";" 4484739";" 2381512";" 2103227";" 4484739";" 3037777";" 2503581";" 1446962";"  718515";"  470144";"  132266";"  158437";"  179441"
"636";"A043590";"2009MM09";"   34184";"   17091";"   17093";" 4014972";" 2017934";" 1997038";" 4014972";" 2752356";" 2294242";" 1262616";"  639598";"  410873";"   91728";"  145899";"  173246"
"637";"A043590";"2009KW03";"  107222";"   53607";"   53615";"13032178";" 6529561";" 6502617";"13032178";" 8899502";" 7339277";" 4132676";" 2067411";" 1332385";"  350618";"  459962";"  521805"
"638";"A043590";"2009MM10";"   34315";"   17151";"   17164";" 3983758";" 2012119";" 1971639";" 3983758";" 2677612";" 2197961";" 1306146";"  628841";"  437420";"  103767";"  163425";"  170228"
"639";"A043590";"2009MM11";"   29820";"   14922";"   14898";" 3158459";" 1593790";" 1564669";" 3158459";" 2049798";" 1745357";" 1108661";"  507897";"  398432";"   91927";"  161560";"  144945"
"640";"A043590";"2009MM12";"   28179";"   14114";"   14065";" 3100569";" 1528222";" 1572347";" 3100569";" 1936722";" 1639890";" 1163847";"  543259";"  409100";"  100746";"  168537";"  139817"
"641";"A043590";"2009KW04";"   92314";"   46187";"   46127";"10242786";" 5134131";" 5108655";"10242786";" 6664132";" 5583208";" 3578654";" 1679997";" 1244952";"  296440";"  493522";"  454990"
"642";"A043590";"2009JJ00";"  391265";"  195624";"  195641";"43523110";"21826162";"21696948";"43523110";"28990471";"24176603";"14532639";" 7131804";" 4861525";" 1218640";" 1837481";" 1805404"
"643";"A043590";"2010MM01";"   28470";"   14207";"   14263";" 2935404";" 1489035";" 1446369";" 2935404";" 1784929";" 1498289";" 1150475";"  524222";"  413515";"   90772";"  178134";"  144609"
"644";"A043590";"2010MM02";"   27102";"   13550";"   13552";" 2855719";" 1416049";" 1439670";" 2855719";" 1847977";" 1564956";" 1007742";"  438838";"  371799";"   81450";"  154687";"  135662"
"645";"A043590";"2010MM03";"   31373";"   15688";"   15685";" 3465611";" 1762140";" 1703471";" 3465611";" 2249379";" 1897497";" 1216232";"  548050";"  446886";"  107724";"  172209";"  166953"
"646";"A043590";"2010KW01";"   86945";"   43445";"   43500";" 9256734";" 4667224";" 4589510";" 9256734";" 5882285";" 4960742";" 3374449";" 1511110";" 1232200";"  279946";"  505030";"  447224"
"647";"A043590";"2010MM04";"   26687";"   13333";"   13354";" 3006985";" 1472647";" 1534338";" 3006985";" 1950351";" 1625490";" 1056634";"  511218";"  366767";"   94737";"  135991";"  136039"
"648";"A043590";"2010MM05";"   34623";"   17314";"   17309";" 4095110";" 2068682";" 2026428";" 4095110";" 2805648";" 2280039";" 1289462";"  650994";"  428642";"  115489";"  141085";"  172068"
"649";"A043590";"2010MM06";"   34346";"   17178";"   17168";" 4104793";" 2058823";" 2045970";" 4104793";" 2748330";" 2268510";" 1356463";"  684091";"  450667";"  120685";"  150375";"  179607"
"650";"A043590";"2010KW02";"   95656";"   47825";"   47831";"11206888";" 5600152";" 5606736";"11206888";" 7504329";" 6174039";" 3702559";" 1846303";" 1246076";"  330911";"  427451";"  487714"
"651";"A043590";"2010MM07";"   37036";"   18505";"   18531";" 4730788";" 2235501";" 2495287";" 4730788";" 3179518";" 2583777";" 1551270";"  744723";"  510870";"  150924";"  172943";"  187003"
"652";"A043590";"2010MM08";"   36728";"   18370";"   18358";" 4642726";" 2468269";" 2174457";" 4642726";" 3120870";" 2551625";" 1521856";"  738406";"  510220";"  159234";"  166573";"  184413"
"653";"A043590";"2010MM09";"   34583";"   17292";"   17291";" 4246919";" 2129844";" 2117075";" 4246919";" 2879591";" 2379834";" 1367328";"  669142";"  461167";"  125472";"  150922";"  184773"
"654";"A043590";"2010KW03";"  108347";"   54167";"   54180";"13620433";" 6833614";" 6786819";"13620433";" 9179979";" 7515236";" 4440454";" 2152271";" 1482257";"  435630";"  490438";"  556189"
"655";"A043590";"2010MM10";"   35453";"   17727";"   17726";" 4308032";" 2179048";" 2128984";" 4308032";" 2905747";" 2352510";" 1402285";"  666264";"  474618";"  132230";"  165119";"  177269"
"656";"A043590";"2010MM11";"   31417";"   15715";"   15702";" 3508154";" 1777568";" 1730586";" 3508154";" 2293615";" 1942322";" 1214539";"  551279";"  436053";"  119464";"  163734";"  152855"
"657";"A043590";"2010MM12";"   28498";"   14262";"   14236";" 3236641";" 1602991";" 1633650";" 3236641";" 2006306";" 1691178";" 1230335";"  567625";"  434161";"  121532";"  172299";"  140330"
"658";"A043590";"2010KW04";"   95368";"   47704";"   47664";"11052827";" 5559607";" 5493220";"11052827";" 7205668";" 5986010";" 3847159";" 1785168";" 1344832";"  373226";"  501152";"  470454"
"659";"A043590";"2010JJ00";"  386316";"  193141";"  193175";"45136882";"22660597";"22476285";"45136882";"29772261";"24636027";"15364621";" 7294852";" 5305365";" 1419713";" 1924071";" 1961581"
"660";"A043590";"2011MM01";"   30363";"   15163";"   15200";" 3257275";" 1658258";" 1599017";" 3257275";" 2016202";" 1697165";" 1241073";"  543475";"  463311";"  117751";"  184480";"  161080"
"661";"A043590";"2011MM02";"   28048";"   14027";"   14021";" 3045631";" 1511230";" 1534401";" 3045631";" 2013665";" 1706782";" 1031966";"  449995";"  412123";"  107744";"  161993";"  142386"
"662";"A043590";"2011MM03";"   32878";"   16439";"   16439";" 3657692";" 1862668";" 1795024";" 3657692";" 2454087";" 2077934";" 1203605";"  559728";"  457726";"  124860";"  170818";"  162048"
"663";"A043590";"2011KW01";"   91289";"   45629";"   45660";" 9960598";" 5032156";" 4928442";" 9960598";" 6483954";" 5481881";" 3476644";" 1553198";" 1333160";"  350355";"  517291";"  465514"
"664";"A043590";"2011MM04";"   35292";"   17639";"   17653";" 4125747";" 2035770";" 2089977";" 4125747";" 2828147";" 2355821";" 1297600";"  633837";"  460568";"  138211";"  160157";"  162200"
"665";"A043590";"2011MM05";"   38013";"   19010";"   19003";" 4472507";" 2264713";" 2207794";" 4472507";" 3164177";" 2593747";" 1308330";"  673676";"  450690";"  132202";"  148688";"  169800"
"666";"A043590";"2011MM06";"   36920";"   18457";"   18463";" 4513455";" 2266956";" 2246499";" 4513455";" 3143255";" 2597017";" 1370200";"  711999";"  459354";"  140583";"  148208";"  170563"
"667";"A043590";"2011KW02";"  110225";"   55106";"   55119";"13111709";" 6567439";" 6544270";"13111709";" 9135579";" 7546585";" 3976130";" 2019512";" 1370612";"  410996";"  457053";"  502563"
"668";"A043590";"2011MM07";"   39555";"   19772";"   19783";" 5150896";" 2449989";" 2700907";" 5150896";" 3570199";" 2889156";" 1580697";"  779420";"  533805";"  170029";"  171228";"  192548"
"669";"A043590";"2011MM08";"   39631";"   19818";"   19813";" 5057815";" 2648185";" 2409630";" 5057815";" 3491964";" 2837020";" 1565851";"  779716";"  535180";"  170923";"  169815";"  194442"
"670";"A043590";"2011MM09";"   37597";"   18792";"   18805";" 4681742";" 2361577";" 2320165";" 4681742";" 3257385";" 2681933";" 1424357";"  707812";"  490133";"  144481";"  156508";"  189144"
"671";"A043590";"2011KW03";"  116783";"   58382";"   58401";"14890453";" 7459751";" 7430702";"14890453";"10319548";" 8408109";" 4570905";" 2266948";" 1559118";"  485433";"  497551";"  576134"
"672";"A043590";"2011MM10";"   38066";"   19040";"   19026";" 4603682";" 2326155";" 2277527";" 4603682";" 3183023";" 2570795";" 1420659";"  687339";"  498022";"  142275";"  165739";"  190008"
"673";"A043590";"2011MM11";"   32324";"   16163";"   16161";" 3580181";" 1806670";" 1773511";" 3580181";" 2399397";" 2029157";" 1180784";"  539006";"  427648";"  118906";"  153569";"  155173"
"674";"A043590";"2011MM12";"   31558";"   15796";"   15762";" 3534002";" 1725807";" 1808195";" 3534002";" 2303809";" 1960664";" 1230193";"  568994";"  444943";"  124553";"  171839";"  148551"
"675";"A043590";"2011KW04";"  101948";"   50999";"   50949";"11717865";" 5858632";" 5859233";"11717865";" 7886229";" 6560616";" 3831636";" 1795339";" 1370613";"  385734";"  491147";"  493732"
"676";"A043590";"2011JJ00";"  420245";"  210116";"  210129";"49680625";"24917978";"24762647";"49680625";"33825310";"27997191";"15855315";" 7634997";" 5633503";" 1632518";" 1963042";" 2037943"
"677";"A043590";"2012MM01";"   31134";"   15555";"   15579";" 3422762";" 1747950";" 1674812";" 3422762";" 2195330";" 1850565";" 1227432";"  552310";"  458122";"  120275";"  182011";"  155836"
"678";"A043590";"2012MM02";"   30069";"   15035";"   15034";" 3295209";" 1619746";" 1675463";" 3295209";" 2177863";" 1843735";" 1117346";"  493172";"  417150";"  112158";"  163542";"  141450"
"679";"A043590";"2012MM03";"   33871";"   16923";"   16948";" 3868093";" 1973751";" 1894342";" 3868093";" 2589361";" 2183122";" 1278732";"  582609";"  475665";"  134027";"  170677";"  170961"
"680";"A043590";"2012KW01";"   95074";"   47513";"   47561";"10586064";" 5341447";" 5244617";"10586064";" 6962554";" 5877422";" 3623510";" 1628091";" 1350937";"  366460";"  516230";"  468247"
"681";"A043590";"2012MM04";"   35348";"   17682";"   17666";" 4189245";" 2061795";" 2127450";" 4189245";" 2875204";" 2372473";" 1314041";"  632793";"  465890";"  132969";"  155130";"  177791"
"682";"A043590";"2012MM05";"   38118";"   19060";"   19058";" 4544332";" 2285340";" 2258992";" 4544332";" 3199268";" 2584756";" 1345064";"  689656";"  453011";"  121092";"  146795";"  185124"
"683";"A043590";"2012MM06";"   37449";"   18719";"   18730";" 4612845";" 2304960";" 2307885";" 4612845";" 3193777";" 2576910";" 1419068";"  737922";"  467364";"  121150";"  152134";"  194080"
"684";"A043590";"2012KW02";"  110915";"   55461";"   55454";"13346422";" 6652095";" 6694327";"13346422";" 9268249";" 7534139";" 4078173";" 2060371";" 1386265";"  375211";"  454059";"  556995"
"685";"A043590";"2012MM07";"   40012";"   20005";"   20007";" 5221595";" 2465269";" 2756326";" 5221595";" 3616378";" 2853546";" 1605217";"  800062";"  517863";"  138369";"  166394";"  213100"
"686";"A043590";"2012MM08";"   39849";"   19921";"   19928";" 5137505";" 2687277";" 2450228";" 5137505";" 3513351";" 2796249";" 1624154";"  804095";"  533942";"  150503";"  166909";"  216530"
"687";"A043590";"2012MM09";"   37488";"   18757";"   18731";" 4760439";" 2397080";" 2363359";" 4760439";" 3301087";" 2675309";" 1459352";"  730943";"  487046";"  124550";"  153352";"  209144"
"688";"A043590";"2012KW03";"  117349";"   58683";"   58666";"15119539";" 7549626";" 7569913";"15119539";"10430816";" 8325104";" 4688723";" 2335100";" 1538851";"  413422";"  486655";"  638774"
"689";"A043590";"2012MM10";"   37782";"   18895";"   18887";" 4643697";" 2347644";" 2296053";" 4643697";" 3210326";" 2580540";" 1433371";"  687633";"  494571";"  138796";"  157513";"  198262"
"690";"A043590";"2012MM11";"   32064";"   16029";"   16035";" 3692267";" 1860056";" 1832211";" 3692267";" 2475265";" 2082343";" 1217002";"  548682";"  442022";"  117274";"  165100";"  159648"
"691";"A043590";"2012MM12";"   30221";"   15130";"   15091";" 3587603";" 1753514";" 1834089";" 3587603";" 2300056";" 1931403";" 1287547";"  581768";"  471228";"  130643";"  184843";"  155742"
"692";"A043590";"2012KW04";"  100067";"   50054";"   50013";"11923567";" 5961214";" 5962353";"11923567";" 7985647";" 6594286";" 3937920";" 1818083";" 1407821";"  386713";"  507456";"  513652"
"693";"A043590";"2012JJ00";"  423405";"  211711";"  211694";"50975592";"25504382";"25471210";"50975592";"34647266";"28330951";"16328326";" 7841645";" 5683874";" 1541806";" 1964400";" 2177668"
"694";"A043590";"2013MM01";"   29949";"   14953";"   14996";" 3386231";" 1718718";" 1667513";" 3386231";" 2116044";" 1758731";" 1270187";"  565379";"  469735";"  121477";"  189528";"  158730"
"695";"A043590";"2013MM02";"   28706";"   14356";"   14350";" 3265809";" 1619700";" 1646109";" 3265809";" 2150859";" 1795354";" 1114950";"  480480";"  418008";"  111327";"  159885";"  146796"
"696";"A043590";"2013MM03";"   32989";"   16489";"   16500";" 3968009";" 2004006";" 1964003";" 3968009";" 2632427";" 2197317";" 1335582";"  608364";"  493470";"  137605";"  177813";"  178052"
"697";"A043590";"2013KW01";"   91644";"   45798";"   45846";"10620049";" 5342424";" 5277625";"10620049";" 6899330";" 5751402";" 3720719";" 1654223";" 1381213";"  370409";"  527226";"  483578"
"698";"A043590";"2013MM04";"   35990";"   17998";"   17992";" 4332719";" 2124194";" 2208525";" 4332719";" 2967311";" 2436293";" 1365408";"  664912";"  481787";"  131468";"  154166";"  196153"
"699";"A043590";"2013MM05";"   39002";"   19494";"   19508";" 4864335";" 2457244";" 2407091";" 4864335";" 3431310";" 2757432";" 1433025";"  740154";"  477309";"  129313";"  150420";"  197576"
"700";"A043590";"2013MM06";"   37816";"   18912";"   18904";" 4855577";" 2420261";" 2435316";" 4855577";" 3336400";" 2711236";" 1519177";"  790054";"  501150";"  139081";"  153598";"  208471"
"701";"A043590";"2013KW02";"  112808";"   56404";"   56404";"14052631";" 7001699";" 7050932";"14052631";" 9735021";" 7904961";" 4317610";" 2195120";" 1460246";"  399862";"  458184";"  602200"
"702";"A043590";"2013MM07";"   40125";"   20056";"   20069";" 5322568";" 2519776";" 2802792";" 5322568";" 3674591";" 2926046";" 1647977";"  835820";"  544779";"  159067";"  164126";"  221586"
"703";"A043590";"2013MM08";"   40004";"   20000";"   20004";" 5333474";" 2785074";" 2548400";" 5333474";" 3631055";" 2888915";" 1702419";"  854470";"  564431";"  171505";"  168922";"  224004"
"704";"A043590";"2013MM09";"   38274";"   19148";"   19126";" 4897174";" 2462704";" 2434470";" 4897174";" 3409623";" 2773296";" 1487551";"  764189";"  511569";"  144898";"  153126";"  213545"
"705";"A043590";"2013KW03";"  118403";"   59204";"   59199";"15553216";" 7767554";" 7785662";"15553216";"10715269";" 8588257";" 4837947";" 2454479";" 1620779";"  475470";"  486174";"  659135"
"706";"A043590";"2013MM10";"   38308";"   19153";"   19155";" 4745696";" 2389293";" 2356403";" 4745696";" 3304504";" 2651597";" 1441192";"  711444";"  519316";"  151822";"  159698";"  207796"
"707";"A043590";"2013MM11";"   32622";"   16315";"   16307";" 3772625";" 1900072";" 1872553";" 3772625";" 2552602";" 2137734";" 1220023";"  562778";"  461137";"  138856";"  159165";"  163116"
"708";"A043590";"2013MM12";"   31780";"   15919";"   15861";" 3783482";" 1856353";" 1927129";" 3783482";" 2464710";" 2066267";" 1318772";"  612527";"  486942";"  156569";"  174901";"  155472"
"709";"A043590";"2013KW04";"  102710";"   51387";"   51323";"12301803";" 6145718";" 6156085";"12301803";" 8321816";" 6855598";" 3979987";" 1886749";" 1467395";"  447247";"  493764";"  526384"
"710";"A043590";"2013JJ00";"  425565";"  212793";"  212772";"52527699";"26257395";"26270304";"52527699";"35671436";"29100218";"16856263";" 8190571";" 5929633";" 1692988";" 1965348";" 2271297"
"711";"A043590";"2014MM01";"   31392";"   15670";"   15722";" 3616552";" 1827701";" 1788851";" 3616552";" 2301528";" 1924373";" 1315024";"  587706";"  508007";"  156163";"  182518";"  169326"
"712";"A043590";"2014MM02";"   29450";"   14721";"   14729";" 3435592";" 1696356";" 1739236";" 3435592";" 2289187";" 1917733";" 1146405";"  492916";"  450701";"  143655";"  155965";"  151081"
"713";"A043590";"2014MM03";"   34033";"   17024";"   17009";" 4076472";" 2066733";" 2009739";" 4076472";" 2744289";" 2307481";" 1332183";"  602415";"  508745";"  164360";"  163313";"  181072"
"714";"A043590";"2014KW01";"   94875";"   47415";"   47460";"11128616";" 5590790";" 5537826";"11128616";" 7335004";" 6149587";" 3793612";" 1683037";" 1467453";"  464178";"  501796";"  501479"
"715";"A043590";"2014MM04";"   36630";"   18312";"   18318";" 4560642";" 2226261";" 2334381";" 4560642";" 3168885";" 2616545";" 1391757";"  662304";"  514063";"  167717";"  154168";"  192178"
"716";"A043590";"2014MM05";"   39493";"   19738";"   19755";" 4987951";" 2516085";" 2471866";" 4987951";" 3537385";" 2878680";" 1450566";"  749101";"  498394";"  146253";"  154397";"  197744"
"717";"A043590";"2014MM06";"   38789";"   19401";"   19388";" 5032637";" 2539668";" 2492969";" 5032637";" 3539691";" 2908600";" 1492946";"  787091";"  501421";"  146203";"  153651";"  201567"
"718";"A043590";"2014KW02";"  114912";"   57451";"   57461";"14581230";" 7282014";" 7299216";"14581230";"10245961";" 8403825";" 4335269";" 2198496";" 1513878";"  460173";"  462216";"  591489"
"719";"A043590";"2014MM07";"   41227";"   20607";"   20620";" 5455674";" 2558772";" 2896902";" 5455674";" 3853130";" 3112911";" 1602544";"  807744";"  550898";"  165357";"  164677";"  220864"
"720";"A043590";"2014MM08";"   41427";"   20715";"   20712";" 5618436";" 2934411";" 2684025";" 5618436";" 3902345";" 3136146";" 1716091";"  844540";"  590670";"  190317";"  169062";"  231291"
"721";"A043590";"2014MM09";"   39685";"   19849";"   19836";" 5185505";" 2600130";" 2585375";" 5185505";" 3650216";" 3016558";" 1535289";"  795183";"  518448";"  152935";"  147984";"  217529"
"722";"A043590";"2014KW03";"  122339";"   61171";"   61168";"16259615";" 8093313";" 8166302";"16259615";"11405691";" 9265615";" 4853924";" 2447467";" 1660016";"  508609";"  481723";"  669684"
"723";"A043590";"2014MM10";"   39756";"   19878";"   19878";" 5023568";" 2535869";" 2487699";" 5023568";" 3546449";" 2893559";" 1477119";"  739098";"  517334";"  162128";"  155667";"  199539"
"724";"A043590";"2014MM11";"   33554";"   16787";"   16767";" 3972843";" 1995290";" 1977553";" 3972843";" 2719549";" 2298319";" 1253294";"  585079";"  468453";"  142874";"  157122";"  168457"
"725";"A043590";"2014MM12";"   32859";"   16452";"   16407";" 3974662";" 1956860";" 2017802";" 3974662";" 2650810";" 2238065";" 1323852";"  624974";"  481491";"  153537";"  168662";"  159292"
"726";"A043590";"2014KW04";"  106169";"   53117";"   53052";"12971073";" 6488019";" 6483054";"12971073";" 8916808";" 7429943";" 4054265";" 1949151";" 1467278";"  458539";"  481451";"  527288"
"727";"A043590";"2014JJ00";"  438295";"  219154";"  219141";"54940534";"27454136";"27486398";"54940534";"37903464";"31248970";"17037070";" 8278151";" 6108625";" 1891499";" 1927186";" 2289940"
"728";"A043590";"2015MM01";"   32032";"   15985";"   16047";" 3719441";" 1874235";" 1845206";" 3719441";" 2407878";" 1993858";" 1311563";"  602564";"  493745";"  149103";"  176454";"  168188"
"729";"A043590";"2015MM02";"   30607";"   15298";"   15309";" 3602644";" 1782456";" 1820188";" 3602644";" 2458211";" 2046556";" 1144433";"  506992";"  443474";"  134920";"  151836";"  156718"
"730";"A043590";"2015MM03";"   34599";"   17310";"   17289";" 4194059";" 2130477";" 2063582";" 4194059";" 2870299";" 2399081";" 1323760";"  622212";"  490769";"  148450";"  157953";"  184366"
"731";"A043590";"2015KW01";"   97238";"   48593";"   48645";"11516144";" 5787168";" 5728976";"11516144";" 7736388";" 6439495";" 3779756";" 1731768";" 1427988";"  432473";"  486243";"  509272"
"732";"A043590";"2015MM04";"   37602";"   18797";"   18805";" 4769994";" 2333141";" 2436853";" 4769994";" 3365931";" 2798257";" 1404063";"  697454";"  497190";"  159174";"  140795";"  197221"
"733";"A043590";"2015MM05";"   41072";"   20535";"   20537";" 5380588";" 2707937";" 2672651";" 5380588";" 3880734";" 3156850";" 1499854";"  801872";"  493971";"  155701";"  141172";"  197098"
"734";"A043590";"2015MM06";"   40066";"   20035";"   20031";" 5321300";" 2660014";" 2661286";" 5321300";" 3781882";" 3109914";" 1539418";"  831330";"  507478";"  157569";"  138453";"  211456"
"735";"A043590";"2015KW02";"  118740";"   59367";"   59373";"15471882";" 7701092";" 7770790";"15471882";"11028547";" 9065021";" 4443335";" 2330656";" 1498639";"  472444";"  420420";"  605775"
"736";"A043590";"2015MM07";"   42494";"   21239";"   21255";" 5914428";" 2790465";" 3123963";" 5914428";" 4197398";" 3372613";" 1717030";"  872530";"  597320";"  193608";"  151270";"  252442"
"737";"A043590";"2015MM08";"   42339";"   21176";"   21163";" 5937238";" 3107242";" 2829996";" 5937238";" 4150650";" 3326400";" 1786588";"  893391";"  626311";"  210165";"  158591";"  257555"
"738";"A043590";"2015MM09";"   40558";"   20286";"   20272";" 5466239";" 2737082";" 2729157";" 5466239";" 3868276";" 3179873";" 1597963";"  836065";"  545266";"  170257";"  143685";"  231324"
"739";"A043590";"2015KW03";"  125391";"   62701";"   62690";"17317905";" 8634789";" 8683116";"17317905";"12216324";" 9878886";" 5101581";" 2601986";" 1768897";"  574030";"  453546";"  741321"
"740";"A043590";"2015MM10";"   40241";"   20108";"   20133";" 5326372";" 2678899";" 2647473";" 5326372";" 3768179";" 3091581";" 1558193";"  796260";"  544140";"  181221";"  148016";"  214903"
"741";"A043590";"2015MM11";"   34454";"   17243";"   17211";" 4325395";" 2169687";" 2155708";" 4325395";" 3016712";" 2544606";" 1308683";"  619611";"  485474";"  171160";"  146868";"  167446"
"742";"A043590";"2015MM12";"   34609";"   17313";"   17296";" 4287593";" 2116536";" 2171057";" 4287593";" 2916811";" 2447820";" 1370782";"  656486";"  502158";"  185041";"  161434";"  155683"
"743";"A043590";"2015KW04";"  109304";"   54664";"   54640";"13939360";" 6965122";" 6974238";"13939360";" 9701702";" 8084007";" 4237658";" 2072357";" 1531772";"  537422";"  456318";"  538032"
"744";"A043590";"2015JJ00";"  450673";"  225325";"  225348";"58245291";"29088171";"29157120";"58245291";"40682961";"33467409";"17562330";" 8736767";" 6227296";" 2016369";" 1816527";" 2394400"
"745";"A043590";"2016MM01";"   33151";"   16567";"   16584";" 4108820";" 2067977";" 2040843";" 4108820";" 2745595";" 2297387";" 1363225";"  634604";"  516877";"  177586";"  163095";"  176196"
"746";"A043590";"2016MM02";"   32959";"   16478";"   16481";" 4095405";" 2024205";" 2071200";" 4095405";" 2880353";" 2423626";" 1215052";"  550982";"  469137";"  168834";"  137090";"  163213"
"747";"A043590";"2016MM03";"   36903";"   18447";"   18456";" 4745869";" 2397134";" 2348735";" 4745869";" 3326928";" 2803110";" 1418941";"  679550";"  525372";"  197696";"  149813";"  177863"
"748";"A043590";"2016KW01";"  103013";"   51492";"   51521";"12950094";" 6489316";" 6460778";"12950094";" 8952876";" 7524123";" 3997218";" 1865136";" 1511386";"  544116";"  449998";"  517272"
"749";"A043590";"2016MM04";"   39780";"   19885";"   19895";" 5243473";" 2545683";" 2697790";" 5243473";" 3736412";" 3137158";" 1507061";"  765587";"  546098";"  196947";"  154080";"  195071"
"750";"A043590";"2016MM05";"   43419";"   21719";"   21700";" 5732006";" 2913429";" 2818577";" 5732006";" 4195512";" 3513728";" 1536494";"  820679";"  525622";"  186586";"  151323";"  187713"
"751";"A043590";"2016MM06";"   42418";"   21208";"   21210";" 5736839";" 2872561";" 2864278";" 5736839";" 4189124";" 3535693";" 1547715";"  831150";"  538881";"  174390";"  154331";"  210160"
"752";"A043590";"2016KW02";"  125617";"   62812";"   62805";"16712318";" 8331673";" 8380645";"16712318";"12121048";"10186579";" 4591270";" 2417416";" 1610601";"  557923";"  459734";"  592944"
"753";"A043590";"2016MM07";"   45260";"   22620";"   22640";" 6370808";" 2995564";" 3375244";" 6370808";" 4578516";" 3808166";" 1792292";"  903224";"  648708";"  225401";"  177159";"  246148"
"754";"A043590";"2016MM08";"   45703";"   22852";"   22851";" 6402126";" 3347204";" 3054922";" 6402126";" 4572032";" 3779001";" 1830094";"  908028";"  664914";"  235578";"  178945";"  250391"
"755";"A043590";"2016MM09";"   43186";"   21589";"   21597";" 5866487";" 2943433";" 2923054";" 5866487";" 4217956";" 3562720";" 1648531";"  848398";"  586163";"  199349";"  164839";"  221975"
"756";"A043590";"2016KW03";"  134149";"   67061";"   67088";"18639421";" 9286201";" 9353220";"18639421";"13368504";"11149887";" 5270917";" 2659650";" 1899785";"  660328";"  520943";"  718514"
"757";"A043590";"2016MM10";"   43389";"   21699";"   21690";" 5782773";" 2921833";" 2860940";" 5782773";" 4148178";" 3484875";" 1634595";"  829436";"  586637";"  202260";"  168711";"  215666"
"758";"A043590";"2016MM11";"   36325";"   18165";"   18160";" 4694112";" 2353958";" 2340154";" 4694112";" 3286965";" 2791429";" 1407147";"  657404";"  538195";"  189631";"  169595";"  178969"
"759";"A043590";"2016MM12";"   36371";"   18198";"   18173";" 4747645";" 2333003";" 2414642";" 4747645";" 3242654";" 2734762";" 1504991";"  711129";"  568364";"  210321";"  174539";"  183504"
"760";"A043590";"2016KW04";"  116085";"   58062";"   58023";"15224530";" 7608794";" 7615736";"15224530";"10677797";" 9011066";" 4546733";" 2197969";" 1693196";"  602212";"  512845";"  578139"
"761";"A043590";"2016JJ00";"  478864";"  239427";"  239437";"63526363";"31715984";"31810379";"63526363";"45120225";"37871655";"18406138";" 9140171";" 6714968";" 2364579";" 1943520";" 2406869"
"762";"A043590";"2017MM01";"   35663";"   17826";"   17837";" 4559527";" 2310862";" 2248665";" 4559527";" 3060824";" 2572846";" 1498703";"  684200";"  588788";"  211757";"  181368";"  195663"
"763";"A043590";"2017MM02";"   33400";"   16697";"   16703";" 4324272";" 2129390";" 2194882";" 4324272";" 3013325";" 2541735";" 1310947";"  581488";"  525506";"  190369";"  157063";"  178074"
"764";"A043590";"2017MM03";"   39436";"   19713";"   19723";" 5161224";" 2622918";" 2538306";" 5161224";" 3625271";" 3067077";" 1535953";"  720334";"  588547";"  216506";"  167836";"  204205"
"765";"A043590";"2017KW01";"  108499";"   54236";"   54263";"14045023";" 7063170";" 6981853";"14045023";" 9699420";" 8181658";" 4345603";" 1986022";" 1702841";"  618632";"  506267";"  577942"
"766";"A043590";"2017MM04";"   41873";"   20936";"   20937";" 5837225";" 2859626";" 2977599";" 5837225";" 4146176";" 3501837";" 1691049";"  865902";"  602792";"  221739";"  161291";"  219762"
"767";"A043590";"2017MM05";"   45418";"   22714";"   22704";" 6207951";" 3134261";" 3073690";" 6207951";" 4502206";" 3816377";" 1705745";"  912406";"  591622";"  202338";"  159184";"  230100"
"768";"A043590";"2017MM06";"   44011";"   22003";"   22008";" 6144775";" 3087275";" 3057500";" 6144775";" 4462101";" 3780026";" 1682674";"  909338";"  582237";"  191349";"  162263";"  228625"
"769";"A043590";"2017KW02";"  131302";"   65653";"   65649";"18189951";" 9081162";" 9108789";"18189951";"13110483";"11098240";" 5079468";" 2687646";" 1776651";"  615426";"  482738";"  678487"
"770";"A043590";"2017MM07";"   46495";"   23241";"   23254";" 6729274";" 3182386";" 3546888";" 6729274";" 4863967";" 4065720";" 1865307";"  952462";"  660185";"  242016";"  174189";"  243980"
"771";"A043590";"2017MM08";"   46863";"   23432";"   23431";" 6788668";" 3520949";" 3267719";" 6788668";" 4904378";" 4073547";" 1884290";"  958942";"  660122";"  246512";"  174183";"  239427"
"772";"A043590";"2017MM09";"   44269";"   22133";"   22136";" 6258281";" 3160005";" 3098276";" 6258281";" 4527676";" 3816494";" 1730605";"  889357";"  613735";"  214627";"  167095";"  232013"
"773";"A043590";"2017KW03";"  137627";"   68806";"   68821";"19776223";" 9863340";" 9912883";"19776223";"14296021";"11955761";" 5480202";" 2800761";" 1934042";"  703155";"  515467";"  715420"
"774";"A043590";"2017MM10";"   44849";"   22426";"   22423";" 6242908";" 3140562";" 3102346";" 6242908";" 4512232";" 3798584";" 1730676";"  859618";"  624179";"  220567";"  170520";"  233092"
"775";"A043590";"2017MM11";"   37963";"   18983";"   18980";" 5170757";" 2597443";" 2573314";" 5170757";" 3643001";" 3096871";" 1527756";"  708793";"  577321";"  194575";"  183500";"  199246"
"776";"A043590";"2017MM12";"   36499";"   18259";"   18240";" 4975525";" 2438150";" 2537375";" 4975525";" 3387426";" 2859205";" 1588099";"  746677";"  589944";"  202452";"  197469";"  190023"
"777";"A043590";"2017KW04";"  119311";"   59668";"   59643";"16389190";" 8176155";" 8213035";"16389190";"11542659";" 9754660";" 4846531";" 2315088";" 1791444";"  617594";"  551489";"  622361"
"778";"A043590";"2017JJ00";"  496739";"  248363";"  248376";"68400387";"34183827";"34216560";"68400387";"48648583";"40990319";"19751804";" 9789517";" 7204978";" 2554807";" 2055961";" 2594210"
"779";"A043590";"2018MM01";"   37113";"   18551";"   18562";" 4908989";" 2477411";" 2431578";" 4908989";" 3322876";" 2792907";" 1586113";"  733448";"  598674";"  198863";"  200566";"  199245"
"780";"A043590";"2018MM02";"   35069";"   17535";"   17534";" 4741806";" 2333281";" 2408525";" 4741806";" 3316805";" 2802166";" 1425001";"  641702";"  556072";"  182629";"  180872";"  192571"
"781";"A043590";"2018MM03";"   40059";"   20019";"   20040";" 5559456";" 2817115";" 2742341";" 5559456";" 3886460";" 3292053";" 1672996";"  795271";"  620364";"  212990";"  191275";"  216099"
"782";"A043590";"2018KW01";"  112241";"   56105";"   56136";"15210251";" 7627807";" 7582444";"15210251";"10526141";" 8887126";" 4684110";" 2170421";" 1775110";"  594482";"  572713";"  607915"
"783";"A043590";"2018MM04";"   41861";"   20933";"   20928";" 6016915";" 2934838";" 3082077";" 6016915";" 4247799";" 3591583";" 1769116";"  903740";"  627372";"  217204";"  176696";"  233472"
"784";"A043590";"2018MM05";"   44742";"   22368";"   22374";" 6393936";" 3236091";" 3157845";" 6393936";" 4617220";" 3895133";" 1776716";"  962691";"  596465";"  191259";"  174269";"  230937"
"785";"A043590";"2018MM06";"   43499";"   21748";"   21751";" 6377393";" 3192260";" 3185133";" 6377393";" 4552594";" 3840755";" 1824799";"  991079";"  612091";"  195720";"  178626";"  237745"
"786";"A043590";"2018KW02";"  130102";"   65049";"   65053";"18788244";" 9363189";" 9425055";"18788244";"13417613";"11327471";" 5370631";" 2857510";" 1835928";"  604183";"  529591";"  702154"
"787";"A043590";"2018MM07";"   45551";"   22779";"   22772";" 6765004";" 3188416";" 3576588";" 6765004";" 4797829";" 4026378";" 1967175";" 1031540";"  671522";"  230359";"  191515";"  249648"
"788";"A043590";"2018MM08";"   45713";"   22856";"   22857";" 6836668";" 3526769";" 3309899";" 6836668";" 4820950";" 4028082";" 2015718";" 1044614";"  691894";"  244056";"  191120";"  256718"
"789";"A043590";"2018MM09";"   44198";"   22101";"   22097";" 6396940";" 3212601";" 3184339";" 6396940";" 4563606";" 3835449";" 1833334";"  969446";"  623245";"  202974";"  180637";"  239634"
"790";"A043590";"2018KW03";"  135462";"   67736";"   67726";"19998612";" 9927786";"10070826";"19998612";"14182385";"11889909";" 5816227";" 3045600";" 1986661";"  677389";"  563272";"  746000"
"791";"A043590";"2018MM10";"   45100";"   22549";"   22551";" 6402290";" 3211073";" 3191217";" 6402290";" 4562671";" 3826613";" 1839619";"  942167";"  636377";"  208226";"  186368";"  241783"
"792";"A043590";"2018MM11";"   38382";"   19193";"   19189";" 5296943";" 2657363";" 2639580";" 5296943";" 3700208";" 3153475";" 1596735";"  770229";"  582296";"  185732";"  189625";"  206939"
"793";"A043590";"2018MM12";"   38157";"   19084";"   19073";" 5260254";" 2573846";" 2686408";" 5260254";" 3590638";" 3048012";" 1669616";"  816561";"  601892";"  200158";"  202731";"  199003"
"794";"A043590";"2018KW04";"  121639";"   60826";"   60813";"16959487";" 8442282";" 8517205";"16959487";"11853517";"10028100";" 5105970";" 2528957";" 1820565";"  594116";"  578724";"  647725"
"795";"A043590";"2018JJ00";"  499444";"  249716";"  249728";"70956594";"35361064";"35595530";"70956594";"49979656";"42132606";"20976938";"10602488";" 7418264";" 2470170";" 2244300";" 2703794"
"796";"A043590";"2019MM01";"   37185";"   18588";"   18597";" 4996131";" 2520292";" 2475839";" 4996131";" 3373101";" 2856935";" 1623030";"  771225";"  600706";"  197945";"  198530";"  204231"
"797";"A043590";"2019MM02";"   35195";"   17590";"   17605";" 4836332";" 2386195";" 2450137";" 4836332";" 3383286";" 2874499";" 1453046";"  678346";"  552485";"  190308";"  171647";"  190530"
"798";"A043590";"2019MM03";"   39785";"   19897";"   19888";" 5630314";" 2847589";" 2782725";" 5630314";" 3947789";" 3361481";" 1682525";"  835790";"  604250";"  215944";"  178766";"  209540"
"799";"A043590";"2019KW01";"  112165";"   56075";"   56090";"15462777";" 7754076";" 7708701";"15462777";"10704176";" 9092915";" 4758601";" 2285361";" 1757441";"  604197";"  548943";"  604301"
"800";"A043590";"2019MM04";"   41892";"   20940";"   20952";" 6104010";" 2983771";" 3120239";" 6104010";" 4314805";" 3657659";" 1789205";"  936294";"  618238";"  223839";"  153991";"  240408"
"801";"A043590";"2019MM05";"   44706";"   22352";"   22354";" 6441473";" 3236047";" 3205426";" 6441473";" 4651471";" 3931201";" 1790002";"  997494";"  583271";"  199898";"  132977";"  250396"
"802";"A043590";"2019MM06";"   43348";"   21676";"   21672";" 6502588";" 3273870";" 3228718";" 6502588";" 4652003";" 3931186";" 1850585";" 1027668";"  594586";"  214493";"  130830";"  249263"
"803";"A043590";"2019KW02";"  129946";"   64968";"   64978";"19048071";" 9493688";" 9554383";"19048071";"13618279";"11520046";" 5429792";" 2961456";" 1796095";"  638230";"  417798";"  740067"
"804";"A043590";"2019MM07";"   44736";"   22366";"   22370";" 6724023";" 3166610";" 3557413";" 6724023";" 4758165";" 3992902";" 1965858";" 1064565";"  646520";"  243180";"  140403";"  262937"
"805";"A043590";"2019MM08";"   45122";"   22558";"   22564";" 6810759";" 3523240";" 3287519";" 6810759";" 4804762";" 4007196";" 2005997";" 1080202";"  660383";"  251293";"  144489";"  264601"
"806";"A043590";"2019MM09";"   44131";"   22075";"   22056";" 6493468";" 3252568";" 3240900";" 6493468";" 4649227";" 3910988";" 1844241";"  998333";"  606741";"  214544";"  137525";"  254672"
"807";"A043590";"2019KW03";"  133989";"   66999";"   66990";"20028250";" 9942418";"10085832";"20028250";"14212154";"11911086";" 5816096";" 3143100";" 1913644";"  709017";"  422417";"  782210"
"808";"A043590";"2019MM10";"   44502";"   22251";"   22251";" 6431122";" 3227860";" 3203262";" 6431122";" 4604704";" 3865499";" 1826418";"  964346";"  613174";"  225690";"  138445";"  249039"
"809";"A043590";"2019MM11";"   37800";"   18901";"   18899";" 5323306";" 2668379";" 2654927";" 5323306";" 3717038";" 3173596";" 1606268";"  795614";"  576872";"  211274";"  148528";"  217070"
"810";"A043590";"2019MM12";"   38425";"   19213";"   19212";" 5386203";" 2640064";" 2746139";" 5386203";" 3698397";" 3152275";" 1687806";"  855812";"  589966";"  222175";"  158395";"  209396"
"811";"A043590";"2019KW04";"  120727";"   60365";"   60362";"17140631";" 8536303";" 8604328";"17140631";"12020139";"10191370";" 5120492";" 2615772";" 1780012";"  659139";"  445368";"  675505"
"812";"A043590";"2019JJ00";"  496827";"  248407";"  248420";"71679729";"35726485";"35953244";"71679729";"50554748";"42715417";"21124981";"11005689";" 7247192";" 2610583";" 1834526";" 2802083"
"813";"A043590";"2020MM01";"   37567";"   18784";"   18783";" 5074773";" 2561003";" 2513770";" 5074773";" 3452707";" 2932396";" 1622066";"  787734";"  590799";"  216030";"  159427";"  215342"
"814";"A043590";"2020MM02";"   34979";"   17492";"   17487";" 4719769";" 2342660";" 2377109";" 4719769";" 3330655";" 2828259";" 1389114";"  712192";"  447071";"  201699";"  141678";"  103694"
"815";"A043590";"2020MM03";"   25155";"   12626";"   12529";" 2476372";" 1298133";" 1178239";" 2476372";" 1641935";" 1387274";"  834437";"  436831";"  252443";"  110189";"   97016";"   45238"
"816";"A043590";"2020KW01";"   97701";"   48902";"   48799";"12270914";" 6201796";" 6069118";"12270914";" 8425297";" 7147929";" 3845617";" 1936757";" 1290313";"  527918";"  398121";"  364274"
"817";"A043590";"2020MM04";"    4236";"    2118";"    2118";"  126015";"   70038";"   55977";"  126015";"   67687";"   55435";"   58328";"   30099";"   24851";"    6143";"    9379";"    9329"
"818";"A043590";"2020MM05";"    5873";"    2930";"    2943";"  207827";"  109314";"   98513";"  207827";"  131546";"  110706";"   76281";"   42055";"   30485";"    5066";"   11729";"   13690"
"819";"A043590";"2020MM06";"    8108";"    4057";"    4051";"  471410";"  229128";"  242282";"  471410";"  338245";"  270952";"  133165";"   74685";"   50940";"   10856";"   21433";"   18651"
"820";"A043590";"2020KW02";"   18217";"    9105";"    9112";"  805252";"  408480";"  396772";"  805252";"  537478";"  437093";"  267774";"  146839";"  106276";"   22065";"   42541";"   41670"
"821";"A043590";"2020MM07";"   15702";"    7831";"    7871";" 1338857";"  608849";"  730008";" 1338857";" 1114398";"  938685";"  224459";"  124208";"   78276";"   26724";"   25566";"   25986"
"822";"A043590";"2020MM08";"   23125";"   11545";"   11580";" 1854786";"  983983";"  870803";" 1854786";" 1608511";" 1366505";"  246275";"  147032";"   75065";"   27925";"   17882";"   29258"
"823";"A043590";"2020MM09";"   22162";"   11087";"   11075";" 1337741";"  684061";"  653680";" 1337741";" 1102721";"  937298";"  235020";"  132894";"   72501";"   24604";"   16689";"   31208"
"824";"A043590";"2020KW03";"   60989";"   30463";"   30526";" 4531384";" 2276893";" 2254491";" 4531384";" 3825630";" 3242488";"  705754";"  404134";"  225842";"   79253";"   60137";"   86452"
"825";"A043590";"2020MM10";"   19614";"    9801";"    9813";" 1143483";"  576128";"  567355";" 1143483";"  874489";"  729708";"  268994";"  146461";"   76382";"   30709";"   17506";"   28167"
"826";"A043590";"2020MM11";"   14858";"    7433";"    7425";"  900434";"  451046";"  449388";"  900434";"  629150";"  503689";"  271284";"  154035";"   72121";"   29950";"   22493";"   19678"
"827";"A043590";"2020MM12";"   15896";"    7956";"    7940";" 1233043";"  580297";"  652746";" 1233043";"  836069";"  685753";"  396974";"  227504";"   90238";"   44781";"   25330";"   20127"
"828";"A043590";"2020KW04";"   50368";"   25190";"   25178";" 3276960";" 1607471";" 1669489";" 3276960";" 2339708";" 1919150";"  937252";"  528000";"  238741";"  105440";"   65329";"   67972"
"829";"A043590";"2020JJ00";"  227275";"  113660";"  113615";"20884510";"10494640";"10389870";"20884510";"15128113";"12746660";" 5756397";" 3015730";" 1861172";"  734676";"  566128";"  560368"
"830";"A043590";"2021MM01";"   14666";"    7317";"    7349";"  869129";"  463793";"  405336";"  869129";"  553464";"  396818";"  315665";"  174464";"   77352";"   37553";"   22350";"   17449"
"831";"A043590";"2021MM02";"   10655";"    5328";"    5327";"  505194";"  253143";"  252051";"  505194";"  327631";"  256374";"  177563";"   88342";"   53244";"   24888";"   18262";"   10094"
"832";"A043590";"2021MM03";"   12217";"    6112";"    6105";"  660176";"  331608";"  328568";"  660176";"  430955";"  319392";"  229221";"  123707";"   68880";"   31593";"   22014";"   15273"
"833";"A043590";"2021KW01";"   37538";"   18757";"   18781";" 2034499";" 1048544";"  985955";" 2034499";" 1312050";"  972584";"  722449";"  386513";"  199476";"   94034";"   62626";"   42816"
"834";"A043590";"2021MM04";"   13720";"    6855";"    6865";"  786652";"  386810";"  399842";"  786652";"  536128";"  382479";"  250524";"  128293";"   79442";"   38019";"   21444";"   19979"
"835";"A043590";"2021MM05";"   15576";"    7790";"    7786";" 1106740";"  552079";"  554661";" 1106740";"  804575";"  608518";"  302165";"  169040";"   83367";"   40749";"   21106";"   21512"
"836";"A043590";"2021MM06";"   19195";"    9593";"    9602";" 1678265";"  816099";"  862166";" 1678265";" 1231479";"  966229";"  446786";"  269639";"  100089";"   47623";"   26362";"   26104"
"837";"A043590";"2021KW02";"   48491";"   24238";"   24253";" 3571657";" 1754988";" 1816669";" 3571657";" 2572182";" 1957226";"  999475";"  566972";"  262898";"  126391";"   68912";"   67595"
"838";"A043590";"2021MM07";"   29141";"   14563";"   14578";" 3029951";" 1378580";" 1651371";" 3029951";" 2303289";" 1817411";"  726662";"  442554";"  145553";"   82938";"   31657";"   30958"
"839";"A043590";"2021MM08";"   31847";"   15929";"   15918";" 3786973";" 2002462";" 1784511";" 3786973";" 2939403";" 2300080";"  847570";"  522054";"  168790";"   99406";"   33806";"   35578"
"840";"A043590";"2021MM09";"   30019";"   15009";"   15010";" 3370205";" 1718856";" 1651349";" 3370205";" 2677291";" 2080979";"  692914";"  435718";"  139106";"   75464";"   30401";"   33241"
"841";"A043590";"2021KW03";"   91007";"   45501";"   45506";"10187129";" 5099898";" 5087231";"10187129";" 7919983";" 6198470";" 2267146";" 1400326";"  453449";"  257808";"   95864";"   99777"
"842";"A043590";"2021MM10";"   31324";"   15655";"   15669";" 3745991";" 1907661";" 1838330";" 3745991";" 2978808";" 2204098";"  767183";"  475162";"  173355";"  104283";"   37117";"   31955"
"843";"A043590";"2021MM11";"   28371";"   14195";"   14176";" 3095823";" 1551581";" 1544242";" 3095823";" 2273366";" 1590431";"  822457";"  518786";"  186876";"  112633";"   47219";"   27024"
"844";"A043590";"2021MM12";"   30225";"   15120";"   15105";" 2855711";" 1329625";" 1526086";" 2855711";" 1924693";" 1369691";"  931018";"  593224";"  214903";"  128246";"   60260";"   26397"
"845";"A043590";"2021KW04";"   89920";"   44970";"   44950";" 9697525";" 4788867";" 4908658";" 9697525";" 7176867";" 5164220";" 2520658";" 1587172";"  575134";"  345162";"  144596";"   85376"
"846";"A043590";"2021JJ00";"  266956";"  133466";"  133490";"25490810";"12692297";"12798513";"25490810";"18981082";"14292500";" 6509728";" 3940983";" 1490957";"  823395";"  371998";"  295564"
"847";"A043590";"2022MM01";"   26231";"   13099";"   13132";" 2488083";" 1334253";" 1153830";" 2488083";" 1664713";" 1180918";"  823370";"  522154";"  177637";"  101785";"   53922";"   21930"
"848";"A043590";"2022MM02";"   24129";"   12070";"   12059";" 2660676";" 1311499";" 1349177";" 2660676";" 1905321";" 1334191";"  755355";"  455413";"  179858";"  112424";"   50494";"   16940"
"849";"A043590";"2022MM03";"   30382";"   15200";"   15182";" 3732048";" 1911518";" 1820530";" 3732048";" 2706725";" 1865976";" 1025323";"  632949";"  241852";"  156282";"   68398";"   17172"
"850";"A043590";"2022KW01";"   80742";"   40369";"   40373";" 8880807";" 4557270";" 4323537";" 8880807";" 6276759";" 4381085";" 2604048";" 1610516";"  599347";"  370491";"  172814";"   56042"
"851";"A043590";"2022MM04";"   33421";"   16680";"   16741";" 4434587";" 2141978";" 2292609";" 4434587";" 3252399";" 2222148";" 1182188";"  766641";"  255461";"  154179";"   79427";"   21855"
"852";"A043590";"2022MM05";"   38419";"   19205";"   19214";" 5217035";" 2674745";" 2542290";" 5217035";" 3891004";" 2692816";" 1326031";"  861886";"  295318";"  167706";"  101792";"   25820"
"853";"A043590";"2022MM06";"   36919";"   18463";"   18456";" 5232630";" 2630931";" 2601699";" 5232630";" 3807896";" 2623208";" 1424734";"  938211";"  304849";"  164309";"  112717";"   27823"
"854";"A043590";"2022KW02";"  108759";"   54348";"   54411";"14884252";" 7447654";" 7436598";"14884252";"10951299";" 7538172";" 3932953";" 2566738";"  855628";"  486194";"  293936";"   75498"
"855";"A043590";"2022MM07";"   36000";"   17982";"   18018";" 5179725";" 2484720";" 2695005";" 5179725";" 3615230";" 2532730";" 1564495";"  999352";"  359476";"  197243";"  125850";"   36383"
"856";"A043590";"2022MM08";"   37730";"   18861";"   18869";" 5327361";" 2790696";" 2536665";" 5327361";" 3743746";" 2619575";" 1583615";"  988004";"  368858";"  207584";"  121306";"   39968"
"857";"A043590";"2022MM09";"   37027";"   18518";"   18509";" 5196931";" 2627876";" 2569055";" 5196931";" 3705504";" 2549113";" 1491427";"  929705";"  354897";"  194317";"  117274";"   43306"
"858";"A043590";"2022KW03";"  110757";"   55361";"   55396";"15704017";" 7903292";" 7800725";"15704017";"11064480";" 7701418";" 4639537";" 2917061";" 1083231";"  599144";"  364430";"  119657"
"859";"A043590";"2022MM10";"   36361";"   18189";"   18172";" 4912421";" 2489573";" 2422848";" 4912421";" 3443474";" 2333504";" 1468947";"  899342";"  355729";"  196436";"  118928";"   40365"
"860";"A043590";"2022MM11";"   30348";"   15178";"   15170";" 3987405";" 2009494";" 1977911";" 3987405";" 2692949";" 1775754";" 1294456";"  720012";"  370482";"  189969";"  134991";"   45522"
"861";"A043590";"2022MM12";"   30669";"   15329";"   15340";" 4101978";" 1988941";" 2113037";" 4101978";" 2709722";" 1772592";" 1392256";"  770908";"  393899";"  200681";"  141236";"   51982"
"862";"A043590";"2022KW04";"   97378";"   48696";"   48682";"13001804";" 6488008";" 6513796";"13001804";" 8846145";" 5881850";" 4155659";" 2390262";" 1120110";"  587086";"  395155";"  137869"
"863";"A043590";"2022JJ00";"  397636";"  198774";"  198862";"52470880";"26396224";"26074656";"52470880";"37138683";"25502525";"15332197";" 9484577";" 3658316";" 2042915";" 1226335";"  389066"
"864";"A043590";"2023MM01";"   29987";"   14994";"   14993";" 3896388";" 1993408";" 1902980";" 3896388";" 2557198";" 1686929";" 1339190";"  720658";"  387914";"  190996";"  138931";"   57987"
"865";"A043590";"2023MM02";"   28345";"   14175";"   14170";" 3782228";" 1868419";" 1913809";" 3782228";" 2569111";" 1702828";" 1213117";"  632782";"  368559";"  180000";"  118650";"   69909"
"866";"A043590";"2023MM03";"   33128";"   16561";"   16567";" 4585101";" 2349324";" 2235777";" 4585101";" 3129905";" 2093162";" 1455196";"  812595";"  417811";"  204809";"  124402";"   88600"
"867";"A043590";"2023KW01";"   91460";"   45730";"   45730";"12263717";" 6211151";" 6052566";"12263717";" 8256214";" 5482919";" 4007503";" 2166035";" 1174284";"  575805";"  381983";"  216496"
"868";"A043590";"2023MM04";"   36258";"   18126";"   18132";" 5128555";" 2512795";" 2615760";" 5128555";" 3586955";" 2433083";" 1541600";"  899023";"  448376";"  207767";"  118478";"  122131"
"869";"A043590";"2023MM05";"   39568";"   19788";"   19780";" 5599870";" 2851081";" 2748789";" 5599870";" 4006221";" 2741697";" 1593649";"  937340";"  457094";"  206441";"  128053";"  122600"
"870";"A043590";"2023MM06";"   38912";"   19449";"   19463";" 5664120";" 2838595";" 2825525";" 5664120";" 4013259";" 2753096";" 1650861";"  968591";"  477368";"  210461";"  129750";"  137157"
"871";"A043590";"2023KW02";"  114738";"   57363";"   57375";"16392545";" 8202471";" 8190074";"16392545";"11606435";" 7927876";" 4786110";" 2804954";" 1382838";"  624669";"  376281";"  381888"
"872";"A043590";"2023MM07";"   40965";"   20476";"   20489";" 6009315";" 2870399";" 3138916";" 6009315";" 4244511";" 2933590";" 1764804";"  996361";"  536411";"  250588";"  136016";"  149807"
"873";"A043590";"2023MM08";"   41584";"   20798";"   20786";" 6052884";" 3138382";" 2914502";" 6052884";" 4278189";" 2947664";" 1774695";" 1001046";"  532533";"  255140";"  129804";"  147589"
"874";"A043590";"2023MM09";"   40625";"   20308";"   20317";" 5777208";" 2917291";" 2859917";" 5777208";" 4138808";" 2852827";" 1638400";"  935225";"  488381";"  220790";"  126364";"  141227"
"875";"A043590";"2023KW03";"  123174";"   61582";"   61592";"17839407";" 8926072";" 8913335";"17839407";"12661508";" 8734081";" 5177899";" 2932632";" 1557325";"  726518";"  392184";"  438623"
"876";"A043590";"2023MM10";"   41553";"   20788";"   20765";" 5820061";" 2939440";" 2880621";" 5820061";" 4177245";" 2834908";" 1642816";"  935262";"  474117";"  198337";"  132911";"  142869"
"877";"A043590";"2023MM11";"   35345";"   17687";"   17658";" 4742398";" 2387151";" 2355247";" 4742398";" 3321264";" 2190203";" 1421134";"  765465";"  431530";"  167343";"  128986";"  135201"
"878";"A043590";"2023MM12";"   35699";"   17830";"   17869";" 4829500";" 2334496";" 2495004";" 4829500";" 3316852";" 2133744";" 1512648";"  825977";"  461417";"  183472";"  142807";"  135138"
"879";"A043590";"2023KW04";"  112597";"   56305";"   56292";"15391959";" 7661087";" 7730872";"15391959";"10815361";" 7158855";" 4576598";" 2526704";" 1367064";"  549152";"  404704";"  413208"
"880";"A043590";"2023JJ00";"  441969";"  220980";"  220989";"61887628";"31000781";"30886847";"61887628";"43339518";"29303731";"18548110";"10430325";" 5481511";" 2476144";" 1555152";" 1450215"
"881";"A043590";"2024MM01";"   35050";"   17529";"   17521";" 4543879";" 2330098";" 2213781";" 4543879";" 3060179";" 2033701";" 1483700";"  775524";"  479021";"  182610";"  143110";"  153301"
"882";"A043590";"2024MM02";"   35103";"   17542";"   17561";" 4626939";" 2307323";" 2319616";" 4626939";" 3230533";" 2139689";" 1396406";"  698431";"  471020";"  182175";"  135290";"  153555"
"883";"A043590";"2024MM03";"   38221";"   19110";"   19111";" 5225678";" 2636392";" 2589286";" 5225678";" 3662128";" 2442900";" 1563550";"  845283";"  492752";"  182877";"  141691";"  168184"
"884";"A043590";"2024KW01";"  108374";"   54181";"   54193";"14396496";" 7273813";" 7122683";"14396496";" 9952840";" 6616290";" 4443656";" 2319238";" 1442793";"  547662";"  420091";"  475040"
"885";"A043590";"2024MM04";"   39142";"   19569";"   19573";" 5470432";" 2677336";" 2793096";" 5470432";" 3913794";" 2671115";" 1556638";"  899787";"  473061";"  178197";"  132235";"  162629"
"886";"A043590";"2024MM05";"   42043";"   21013";"   21030";" 5975694";" 3050631";" 2925063";" 5975694";" 4350862";" 3004337";" 1624832";"  955932";"  477064";"  181966";"  134779";"  160319"
"887";"A043590";"2024MM06";"   40857";"   20430";"   20427";" 5958047";" 3005969";" 2952078";" 5958047";" 4320383";" 2981380";" 1637664";"  958163";"  482710";"  185228";"  132614";"  164868"
"888";"A043590";"2024KW02";"  122042";"   61012";"   61030";"17404173";" 8733936";" 8670237";"17404173";"12585039";" 8656832";" 4819134";" 2813882";" 1432835";"  545391";"  399628";"  487816"
"889";"A043590";"2024MM07";"   42452";"   21224";"   21228";" 6300801";" 2984717";" 3316084";" 6300801";" 4535569";" 3122751";" 1765232";" 1003351";"  534621";"  205453";"  140874";"  188294"
"890";"A043590";"2024MM08";"   43117";"   21561";"   21556";" 6417039";" 3362299";" 3054740";" 6417039";" 4618422";" 3201105";" 1798617";" 1017189";"  542812";"  202101";"  143789";"  196922"
"891";"A043590";"2024MM09";"   41778";"   20895";"   20883";" 6030813";" 3042558";" 2988255";" 6030813";" 4394616";" 3059544";" 1636197";"  924046";"  508147";"  186839";"  136383";"  184925"
"892";"A043590";"2024KW03";"  127347";"   63680";"   63667";"18748653";" 9389574";" 9359079";"18748653";"13548607";" 9383400";" 5200046";" 2944586";" 1585580";"  594393";"  421046";"  570141"
"893";"A043590";"2024MM10";"   42005";"   20997";"   21008";" 6038966";" 3011654";" 3027312";" 6038966";" 4371263";" 2999881";" 1667703";"  932524";"  513326";"  189743";"  142957";"  180626"
"894";"A043590";"2024MM11";"   36588";"   18287";"   18301";" 5071186";" 2593604";" 2477582";" 5071186";" 3572442";" 2377054";" 1498744";"  774442";"  493485";"  184578";"  154933";"  153974"
"895";"A043590";"2024MM12";"   37447";"   18712";"   18735";" 5164857";" 2503280";" 2661577";" 5164857";" 3578117";" 2335129";" 1586740";"  849392";"  497704";"  195577";"  156909";"  145218"
"896";"A043590";"2024KW04";"  116040";"   57996";"   58044";"16275009";" 8108538";" 8166471";"16275009";"11521822";" 7712064";" 4753187";" 2556358";" 1504515";"  569898";"  454799";"  479818"
"897";"A043590";"2024JJ00";"  473803";"  236869";"  236934";"66824331";"33505861";"33318470";"66824331";"47608308";"32368586";"19216023";"10634064";" 5965723";" 2257344";" 1695564";" 2012815"
"898";"A043590";"2025MM01";"   35714";"   17844";"   17870";" 4804006";" 2461205";" 2342801";" 4804006";" 3240908";" 2151574";" 1563098";"  785303";"  528316";"  197871";"  164971";"  165474"
"899";"A043590";"2025MM02";"   34339";"   17155";"   17184";" 4693266";" 2332919";" 2360347";" 4693266";" 3288773";" 2189698";" 1404493";"  684280";"  487498";"  189444";"  151803";"  146251"
"900";"A043590";"2025MM03";"   38870";"   19417";"   19453";" 5324550";" 2721094";" 2603456";" 5324550";" 3772351";" 2543629";" 1552199";"  831904";"  498742";"  180090";"  151083";"  167569"
"901";"A043590";"2025KW01";"  108923";"   54416";"   54507";"14821822";" 7515218";" 7306604";"14821822";"10302032";" 6884901";" 4519790";" 2301487";" 1514556";"  567405";"  467857";"  479294"
"902";"A043590";"2025MM04";"   40363";"   20176";"   20187";" 5825953";" 2855757";" 2970196";" 5825953";" 4175041";" 2869473";" 1650912";"  932417";"  507958";"  192129";"  138376";"  177453"
"903";"A043590";"2025MM05";"   42674";"   21317";"   21357";" 6089817";" 3109566";" 2980251";" 6089817";" 4438586";" 3129646";" 1651231";"  955423";"  495770";"  183269";"  136445";"  176056"
"904";"A043590";"2025MM06";"   40737";"   20360";"   20377";" 6032528";" 3083842";" 2948686";" 6032528";" 4381736";" 3095780";" 1650792";"  975933";"  471091";"  155928";"  137443";"  177720"
"905";"A043590";"2025KW02";"  123774";"   61853";"   61921";"17948298";" 9049165";" 8899133";"17948298";"12995363";" 9094899";" 4952935";" 2863773";" 1474819";"  531326";"  412264";"  531229"
"906";"A043590";"2025MM07";"   43320";"   21646";"   21674";" 6552356";" 3107088";" 3445268";" 6552356";" 4729405";" 3328131";" 1822951";" 1029468";"  555177";"  215357";"  148907";"  190913"
"907";"A043590";"2025MM08";"   43614";"   21806";"   21808";" 6621920";" 3513624";" 3108296";" 6621920";" 4742803";" 3322106";" 1879117";" 1042376";"  585455";"  227935";"  157954";"  199566"
"908";"A043596";"1997JJ00";"   22077";"   11023";"   11054";"  469487";"  234738";"  234749";"  469487";"  457478";"  452244";"   12009";"       0";"       0";"       0";"       0";"       0"
"909";"A043596";"1998JJ00";"   21409";"   10698";"   10711";"  542900";"  273889";"  269011";"  542900";"  527607";"  507113";"   15293";"       0";"       0";"       0";"       0";"       0"
"910";"A043596";"1999MM01";"    1586";"     794";"     792";"   35454";"   18051";"   17403";"   35454";"   34822";"   34538";"     632";"       0";"       0";"       0";"       0";"       0"
"911";"A043596";"1999MM02";"    1570";"     780";"     790";"   39278";"   20702";"   18576";"   39278";"   38173";"   37628";"    1105";"       0";"       0";"       0";"       0";"       0"
"912";"A043596";"1999MM03";"    1875";"     939";"     936";"   40121";"   20329";"   19792";"   40121";"   38543";"   37159";"    1578";"       0";"       0";"       0";"       0";"       0"
"913";"A043596";"1999KW01";"    5031";"    2513";"    2518";"  114853";"   59082";"   55771";"  114853";"  111538";"  109325";"    3315";"       0";"       0";"       0";"       0";"       0"
"914";"A043596";"1999MM04";"    1732";"     870";"     862";"   39909";"   18664";"   21245";"   39909";"   39414";"   35929";"     495";"       0";"       0";"       0";"       0";"       0"
"915";"A043596";"1999MM05";"    1918";"     962";"     956";"   64967";"   31911";"   33056";"   64967";"   64394";"   60919";"     573";"       0";"       0";"       0";"       0";"       0"
"916";"A043596";"1999MM06";"    2050";"    1024";"    1026";"   57489";"   28348";"   29141";"   57489";"   56847";"   54890";"     642";"       0";"       0";"       0";"       0";"       0"
"917";"A043596";"1999KW02";"    5700";"    2856";"    2844";"  162365";"   78923";"   83442";"  162365";"  160655";"  151738";"    1710";"       0";"       0";"       0";"       0";"       0"
"918";"A043596";"1999MM07";"    1876";"     939";"     937";"   64185";"   28780";"   35405";"   64185";"   61346";"   59063";"    2839";"       0";"       0";"       0";"       0";"       0"
"919";"A043596";"1999MM08";"    1962";"     982";"     980";"   64680";"   35062";"   29618";"   64680";"   60142";"   56863";"    4538";"       0";"       0";"       0";"       0";"       0"
"920";"A043596";"1999MM09";"    2135";"    1068";"    1067";"   63346";"   30502";"   32844";"   63346";"   62433";"   59087";"     913";"       0";"       0";"       0";"       0";"       0"
"921";"A043596";"1999KW03";"    5973";"    2989";"    2984";"  192211";"   94344";"   97867";"  192211";"  183921";"  175013";"    8290";"       0";"       0";"       0";"       0";"       0"
"922";"A043596";"1999MM10";"    2099";"    1055";"    1044";"   62131";"   32735";"   29396";"   62131";"   61325";"   55623";"     806";"       0";"       0";"       0";"       0";"       0"
"923";"A043596";"1999MM11";"    1896";"     949";"     947";"   41733";"   21246";"   20487";"   41733";"   40262";"   39734";"    1471";"       0";"       0";"       0";"       0";"       0"
"924";"A043596";"1999MM12";"    1606";"     797";"     809";"   33874";"   17649";"   16225";"   33874";"   33407";"   33320";"     467";"       0";"       0";"       0";"       0";"       0"
"925";"A043596";"1999KW04";"    5601";"    2801";"    2800";"  137738";"   71630";"   66108";"  137738";"  134994";"  128677";"    2744";"       0";"       0";"       0";"       0";"       0"
"926";"A043596";"1999JJ00";"   22305";"   11159";"   11146";"  607167";"  303979";"  303188";"  607167";"  591108";"  564753";"   16059";"       0";"       0";"       0";"       0";"       0"
"927";"A043596";"2000MM01";"    1803";"     904";"     899";"   35006";"   17714";"   17292";"   35006";"   34095";"   33447";"     911";"       0";"     285";"       0";"       0";"     285"
"928";"A043596";"2000MM02";"    1842";"     921";"     921";"   38721";"   19023";"   19698";"   38721";"   37819";"   37476";"     902";"       0";"     138";"     138";"       0";"       0"
"929";"A043596";"2000MM03";"    2075";"    1037";"    1038";"   46757";"   23657";"   23100";"   46757";"   45595";"   44565";"    1162";"       0";"       0";"       0";"       0";"       0"
"930";"A043596";"2000KW01";"    5720";"    2862";"    2858";"  120484";"   60394";"   60090";"  120484";"  117509";"  115488";"    2975";"       0";"     423";"     138";"       0";"     285"
"931";"A043596";"2000MM04";"    2085";"    1048";"    1037";"   52305";"   24727";"   27578";"   52305";"   51581";"   48166";"     724";"       0";"      21";"      21";"       0";"       0"
"932";"A043596";"2000MM05";"    2398";"    1201";"    1197";"   74601";"   37706";"   36895";"   74601";"   74580";"   70371";"      21";"       0";"      21";"      21";"       0";"       0"
"933";"A043596";"2000MM06";"    2419";"    1212";"    1207";"   79429";"   39820";"   39609";"   79429";"   78913";"   69232";"     516";"       0";"       0";"       0";"       0";"       0"
"934";"A043596";"2000KW02";"    6902";"    3461";"    3441";"  206335";"  102253";"  104082";"  206335";"  205074";"  187769";"    1261";"       0";"      42";"      42";"       0";"       0"
"935";"A043596";"2000MM07";"    2215";"    1108";"    1107";"   77105";"   34157";"   42948";"   77105";"   70717";"   65714";"    6388";"       0";"       0";"       0";"       0";"       0"
"936";"A043596";"2000MM08";"    2117";"    1054";"    1063";"   71070";"   40384";"   30686";"   71070";"   64542";"   58476";"    6528";"       0";"       0";"       0";"       0";"       0"
"937";"A043596";"2000MM09";"    2187";"    1096";"    1091";"   76253";"   37672";"   38581";"   76253";"   74898";"   68408";"    1355";"      88";"      87";"      87";"       0";"       0"
"938";"A043596";"2000KW03";"    6519";"    3258";"    3261";"  224428";"  112213";"  112215";"  224428";"  210157";"  192598";"   14271";"      88";"      87";"      87";"       0";"       0"
"939";"A043596";"2000MM10";"    2256";"    1125";"    1131";"   69313";"   37688";"   31625";"   69313";"   69313";"   64536";"       0";"       0";"       0";"       0";"       0";"       0"
"940";"A043596";"2000MM11";"    1920";"     962";"     958";"   42773";"   21792";"   20981";"   42773";"   42773";"   42544";"       0";"       0";"       0";"       0";"       0";"       0"
"941";"A043596";"2000MM12";"    1489";"     743";"     746";"   33279";"   16845";"   16434";"   33279";"   33279";"   32953";"       0";"       0";"       0";"       0";"       0";"       0"
"942";"A043596";"2000KW04";"    5665";"    2830";"    2835";"  145365";"   76325";"   69040";"  145365";"  145365";"  140033";"       0";"       0";"       0";"       0";"       0";"       0"
"943";"A043596";"2000JJ00";"   24806";"   12411";"   12395";"  696612";"  351185";"  345427";"  696612";"  678105";"  635888";"   18507";"      88";"     552";"     267";"       0";"     285"
"944";"A043596";"2001MM01";"    1795";"     898";"     897";"   34865";"   17754";"   17111";"   34865";"   34865";"   34206";"       0";"       0";"       0";"       0";"       0";"       0"
"945";"A043596";"2001MM02";"    1614";"     808";"     806";"   34790";"   17295";"   17495";"   34790";"   34790";"   33882";"       0";"       0";"       0";"       0";"       0";"       0"
"946";"A043596";"2001MM03";"    1879";"     937";"     942";"   42902";"   21754";"   21148";"   42902";"   42862";"   40790";"      40";"       0";"       0";"       0";"       0";"       0"
"947";"A043596";"2001KW01";"    5288";"    2643";"    2645";"  112557";"   56803";"   55754";"  112557";"  112517";"  108878";"      40";"       0";"       0";"       0";"       0";"       0"
"948";"A043596";"2001MM04";"    1428";"     716";"     712";"   56380";"   25824";"   30556";"   56380";"   56210";"   51946";"     170";"       0";"     130";"     130";"       0";"       0"
"949";"A043596";"2001MM05";"    1723";"     861";"     862";"   81744";"   39981";"   41763";"   81744";"   81500";"   73799";"     244";"       0";"     244";"     244";"       0";"       0"
"950";"A043596";"2001MM06";"    1800";"     898";"     902";"   76968";"   38800";"   38168";"   76968";"   76050";"   71155";"     918";"       0";"     170";"     170";"       0";"       0"
"951";"A043596";"2001KW02";"    4951";"    2475";"    2476";"  215092";"  104605";"  110487";"  215092";"  213760";"  196900";"    1332";"       0";"     544";"     544";"       0";"       0"
"952";"A043596";"2001MM07";"    1891";"     948";"     943";"   93388";"   41665";"   51723";"   93388";"   86580";"   75659";"    6808";"       0";"     249";"     249";"       0";"       0"
"953";"A043596";"2001MM08";"    1954";"     974";"     980";"  101666";"   60189";"   41477";"  101666";"   91086";"   77453";"   10580";"       0";"     294";"     294";"       0";"       0"
"954";"A043596";"2001MM09";"    1852";"     928";"     924";"   84783";"   44172";"   40611";"   84783";"   80756";"   72959";"    4027";"       0";"     943";"     943";"       0";"       0"
"955";"A043596";"2001KW03";"    5697";"    2850";"    2847";"  279837";"  146026";"  133811";"  279837";"  258422";"  226071";"   21415";"       0";"    1486";"    1486";"       0";"       0"
"956";"A043596";"2001MM10";"    1804";"     905";"     899";"   75952";"   42365";"   33587";"   75952";"   75488";"   67198";"     464";"       0";"     464";"     464";"       0";"       0"
"957";"A043596";"2001MM11";"    1221";"     610";"     611";"   36609";"   18804";"   17805";"   36609";"   36438";"   35850";"     171";"       0";"     171";"     171";"       0";"       0"
"958";"A043596";"2001MM12";"     972";"     484";"     488";"   27780";"   13525";"   14255";"   27780";"   27780";"   27591";"       0";"       0";"       0";"       0";"       0";"       0"
"959";"A043596";"2001KW04";"    3997";"    1999";"    1998";"  140341";"   74694";"   65647";"  140341";"  139706";"  130639";"     635";"       0";"     635";"     635";"       0";"       0"
"960";"A043596";"2001JJ00";"   19933";"    9967";"    9966";"  747827";"  382128";"  365699";"  747827";"  724405";"  662488";"   23422";"       0";"    2665";"    2665";"       0";"       0"
"961";"A043596";"2002MM01";"    1306";"     651";"     655";"   32355";"   16646";"   15709";"   32355";"   32197";"   31908";"     158";"       0";"       0";"       0";"       0";"       0"
"962";"A043596";"2002MM02";"    1255";"     629";"     626";"   35280";"   17448";"   17832";"   35280";"   35280";"   34889";"       0";"       0";"       0";"       0";"       0";"       0"
"963";"A043596";"2002MM03";"    1406";"     699";"     707";"   42660";"   21658";"   21002";"   42660";"   42660";"   41640";"       0";"       0";"       0";"       0";"       0";"       0"
"964";"A043596";"2002KW01";"    3967";"    1979";"    1988";"  110295";"   55752";"   54543";"  110295";"  110137";"  108437";"     158";"       0";"       0";"       0";"       0";"       0"
"965";"A043596";"2002MM04";"    1427";"     708";"     719";"   47908";"   22277";"   25631";"   47908";"   47908";"   45245";"       0";"       0";"       0";"       0";"       0";"       0"
"966";"A043596";"2002MM05";"    1677";"     839";"     838";"   66776";"   34325";"   32451";"   66776";"   66736";"   60105";"      40";"      40";"       0";"       0";"       0";"       0"
"967";"A043596";"2002MM06";"    1645";"     819";"     826";"   60879";"   30312";"   30567";"   60879";"   60151";"   54586";"     728";"      68";"       0";"       0";"       0";"       0"
"968";"A043596";"2002KW02";"    4749";"    2366";"    2383";"  175563";"   86914";"   88649";"  175563";"  174795";"  159936";"     768";"     108";"       0";"       0";"       0";"       0"
"969";"A043596";"2002MM07";"    1642";"     817";"     825";"   66950";"   29293";"   37657";"   66950";"   63083";"   55387";"    3867";"       0";"       0";"       0";"       0";"       0"
"970";"A043596";"2002MM08";"    1639";"     819";"     820";"   66630";"   38611";"   28019";"   66630";"   61353";"   53488";"    5277";"       0";"       0";"       0";"       0";"       0"
"971";"A043596";"2002MM09";"    1707";"     852";"     855";"   63603";"   31840";"   31763";"   63603";"   62848";"   56805";"     755";"       0";"       0";"       0";"       0";"       0"
"972";"A043596";"2002KW03";"    4988";"    2488";"    2500";"  197183";"   99744";"   97439";"  197183";"  187284";"  165680";"    9899";"       0";"       0";"       0";"       0";"       0"
"973";"A043596";"2002MM10";"    1707";"     850";"     857";"   58900";"   31432";"   27468";"   58900";"   58900";"   51935";"       0";"       0";"       0";"       0";"       0";"       0"
"974";"A043596";"2002MM11";"    1437";"     725";"     712";"   38518";"   19577";"   18941";"   38518";"   38485";"   37265";"      33";"       0";"      33";"      33";"       0";"       0"
"975";"A043596";"2002MM12";"    1143";"     565";"     578";"   31562";"   15388";"   16174";"   31562";"   31562";"   30577";"       0";"       0";"       0";"       0";"       0";"       0"
"976";"A043596";"2002KW04";"    4287";"    2140";"    2147";"  128980";"   66397";"   62583";"  128980";"  128947";"  119777";"      33";"       0";"      33";"      33";"       0";"       0"
"977";"A043596";"2002JJ00";"   17991";"    8973";"    9018";"  612021";"  308807";"  303214";"  612021";"  601163";"  553830";"   10858";"     108";"      33";"      33";"       0";"       0"
"978";"A043596";"2003MM01";"    1010";"     498";"     512";"   30951";"   15984";"   14967";"   30951";"   30951";"   30504";"       0";"       0";"       0";"       0";"       0";"       0"
"979";"A043596";"2003MM02";"    1058";"     524";"     534";"   35045";"   17144";"   17901";"   35045";"   35045";"   34068";"       0";"       0";"       0";"       0";"       0";"       0"
"980";"A043596";"2003MM03";"    1163";"     579";"     584";"   38499";"   19872";"   18627";"   38499";"   38499";"   35097";"       0";"       0";"       0";"       0";"       0";"       0"
"981";"A043596";"2003KW01";"    3231";"    1601";"    1630";"  104495";"   53000";"   51495";"  104495";"  104495";"   99669";"       0";"       0";"       0";"       0";"       0";"       0"
"982";"A043596";"2003MM04";"    1154";"     575";"     579";"   45034";"   19798";"   25236";"   45034";"   45034";"   43106";"       0";"       0";"       0";"       0";"       0";"       0"
"983";"A043596";"2003MM05";"    1447";"     726";"     721";"   66908";"   33162";"   33746";"   66908";"   66908";"   58582";"       0";"       0";"       0";"       0";"       0";"       0"
"984";"A043596";"2003MM06";"    1355";"     676";"     679";"   63270";"   32343";"   30927";"   63270";"   63270";"   55941";"       0";"       0";"       0";"       0";"       0";"       0"
"985";"A043596";"2003KW02";"    3956";"    1977";"    1979";"  175212";"   85303";"   89909";"  175212";"  175212";"  157629";"       0";"       0";"       0";"       0";"       0";"       0"
"986";"A043596";"2003MM07";"    1429";"     721";"     708";"   71569";"   31587";"   39982";"   71569";"   68236";"   55948";"    3333";"       0";"       0";"       0";"       0";"       0"
"987";"A043596";"2003MM08";"    1268";"     632";"     636";"   64823";"   38428";"   26395";"   64823";"   61258";"   49429";"    3565";"       0";"       0";"       0";"       0";"       0"
"988";"A043596";"2003MM09";"    1459";"     727";"     732";"   63448";"   31063";"   32385";"   63448";"   63216";"   55205";"     232";"       0";"       0";"       0";"       0";"       0"
"989";"A043596";"2003KW03";"    4156";"    2080";"    2076";"  199840";"  101078";"   98762";"  199840";"  192710";"  160582";"    7130";"       0";"       0";"       0";"       0";"       0"
"990";"A043596";"2003MM10";"    1223";"     610";"     613";"   60453";"   32117";"   28336";"   60453";"   60453";"   51366";"       0";"       0";"       0";"       0";"       0";"       0"
"991";"A043596";"2003MM11";"    1036";"     519";"     517";"   40759";"   21394";"   19365";"   40759";"   40759";"   38016";"       0";"       0";"       0";"       0";"       0";"       0"
"992";"A043596";"2003MM12";"     856";"     431";"     425";"   36064";"   17571";"   18493";"   36064";"   35825";"   33188";"     239";"       0";"       0";"       0";"       0";"       0"
"993";"A043596";"2003KW04";"    3115";"    1560";"    1555";"  137276";"   71082";"   66194";"  137276";"  137037";"  122570";"     239";"       0";"       0";"       0";"       0";"       0"
"994";"A043596";"2003JJ00";"   14458";"    7218";"    7240";"  616823";"  310463";"  306360";"  616823";"  609454";"  540450";"    7369";"       0";"       0";"       0";"       0";"       0"
"995";"A043596";"2004MM01";"     945";"     458";"     487";"   36511";"   18421";"   18090";"   36511";"   36511";"   35201";"       0";"       0";"       0";"       0";"       0";"       0"
"996";"A043596";"2004MM02";"    1090";"     539";"     551";"   40400";"   19705";"   20695";"   40400";"   40356";"   38348";"      44";"       0";"       0";"       0";"       0";"       0"
"997";"A043596";"2004MM03";"    1435";"     704";"     731";"   62096";"   31111";"   30985";"   62096";"   61946";"   55192";"     150";"       0";"       0";"       0";"       0";"       0"
"998";"A043596";"2004KW01";"    3470";"    1701";"    1769";"  139007";"   69237";"   69770";"  139007";"  138813";"  128741";"     194";"       0";"       0";"       0";"       0";"       0"
"999";"A043596";"2004MM04";"    1524";"     760";"     764";"   97008";"   45025";"   51983";"   97008";"   96988";"   79796";"      20";"      20";"       0";"       0";"       0";"       0"
"1000";"A043596";"2004MM05";"    1658";"     826";"     832";"  114942";"   57825";"   57117";"  114942";"  114942";"   93853";"       0";"       0";"       0";"       0";"       0";"       0"
"1001";"A043596";"2004MM06";"    1907";"     950";"     957";"  111210";"   55532";"   55678";"  111210";"  111210";"   93580";"       0";"       0";"       0";"       0";"       0";"       0"
"1002";"A043596";"2004KW02";"    5089";"    2536";"    2553";"  323160";"  158382";"  164778";"  323160";"  323140";"  267229";"      20";"      20";"       0";"       0";"       0";"       0"
"1003";"A043596";"2004MM07";"    1730";"     860";"     870";"  124052";"   57074";"   66978";"  124052";"  124052";"  100022";"       0";"       0";"       0";"       0";"       0";"       0"
"1004";"A043596";"2004MM08";"    1661";"     826";"     835";"  121751";"   65421";"   56330";"  121751";"  121748";"   99536";"       3";"       3";"       0";"       0";"       0";"       0"
"1005";"A043596";"2004MM09";"    1762";"     883";"     879";"  111949";"   55497";"   56452";"  111949";"  111872";"   94869";"      77";"      27";"       0";"       0";"       0";"       0"
"1006";"A043596";"2004KW03";"    5153";"    2569";"    2584";"  357752";"  177992";"  179760";"  357752";"  357672";"  294427";"      80";"      30";"       0";"       0";"       0";"       0"
"1007";"A043596";"2004MM10";"    1755";"     879";"     876";"  115922";"   60025";"   55897";"  115922";"  115872";"   92594";"      50";"       0";"       0";"       0";"       0";"       0"
"1008";"A043596";"2004MM11";"    1499";"     748";"     751";"   82476";"   41830";"   40646";"   82476";"   82075";"   71782";"     401";"       0";"       0";"       0";"       0";"       0"
"1009";"A043596";"2004MM12";"    1313";"     659";"     654";"   78197";"   38320";"   39877";"   78197";"   78157";"   70562";"      40";"       0";"       0";"       0";"       0";"       0"
"1010";"A043596";"2004KW04";"    4567";"    2286";"    2281";"  276595";"  140175";"  136420";"  276595";"  276104";"  234938";"     491";"       0";"       0";"       0";"       0";"       0"
"1011";"A043596";"2004JJ00";"   18279";"    9092";"    9187";" 1096514";"  545786";"  550728";" 1096514";" 1095729";"  925335";"     785";"      50";"       0";"       0";"       0";"       0"
"1012";"A043596";"2005MM01";"    1342";"     657";"     685";"   72452";"   37106";"   35346";"   72452";"   71805";"   64480";"     647";"       0";"       0";"       0";"       0";"       0"
"1013";"A043596";"2005MM02";"    1444";"     711";"     733";"   73154";"   36279";"   36875";"   73154";"   73108";"   64603";"      46";"       1";"       0";"       0";"       0";"       0"
"1014";"A043596";"2005MM03";"    1633";"     818";"     815";"   86574";"   44413";"   42161";"   86574";"   85041";"   75700";"    1533";"     977";"     294";"     294";"       0";"       0"
"1015";"A043596";"2005KW01";"    4419";"    2186";"    2233";"  232180";"  117798";"  114382";"  232180";"  229954";"  204783";"    2226";"     978";"     294";"     294";"       0";"       0"
"1016";"A043596";"2005MM04";"    1541";"     767";"     774";"   86409";"   41853";"   44556";"   86409";"   86409";"   75558";"       0";"       0";"       0";"       0";"       0";"       0"
"1017";"A043596";"2005MM05";"    1601";"     799";"     802";"  101831";"   50507";"   51324";"  101831";"  101831";"   89201";"       0";"       0";"       0";"       0";"       0";"       0"
"1018";"A043596";"2005MM06";"    1714";"     858";"     856";"  102993";"   51567";"   51426";"  102993";"  102993";"   89356";"       0";"       0";"       0";"       0";"       0";"       0"
"1019";"A043596";"2005KW02";"    4856";"    2424";"    2432";"  291233";"  143927";"  147306";"  291233";"  291233";"  254115";"       0";"       0";"       0";"       0";"       0";"       0"
"1020";"A043596";"2005MM07";"    1628";"     820";"     808";"  110488";"   51894";"   58594";"  110488";"  110488";"   92167";"       0";"       0";"       0";"       0";"       0";"       0"
"1021";"A043596";"2005MM08";"    1468";"     735";"     733";"   96942";"   51945";"   44997";"   96942";"   96942";"   83680";"       0";"       0";"       0";"       0";"       0";"       0"
"1022";"A043596";"2005MM09";"    1455";"     725";"     730";"   78659";"   38212";"   40447";"   78659";"   78659";"   71551";"       0";"       0";"       0";"       0";"       0";"       0"
"1023";"A043596";"2005KW03";"    4551";"    2280";"    2271";"  286089";"  142051";"  144038";"  286089";"  286089";"  247398";"       0";"       0";"       0";"       0";"       0";"       0"
"1024";"A043596";"2005MM10";"    1342";"     672";"     670";"   74208";"   38870";"   35338";"   74208";"   74193";"   66162";"      15";"       0";"       0";"       0";"       0";"       0"
"1025";"A043596";"2005MM11";"    1365";"     683";"     682";"   68344";"   35376";"   32968";"   68344";"   67888";"   65816";"     456";"     456";"       0";"       0";"       0";"       0"
"1026";"A043596";"2005MM12";"    1099";"     548";"     551";"   58896";"   28234";"   30662";"   58896";"   58896";"   57896";"       0";"       0";"       0";"       0";"       0";"       0"
"1027";"A043596";"2005KW04";"    3806";"    1903";"    1903";"  201448";"  102480";"   98968";"  201448";"  200977";"  189874";"     471";"     456";"       0";"       0";"       0";"       0"
"1028";"A043596";"2005JJ00";"   17632";"    8793";"    8839";" 1010950";"  506256";"  504694";" 1010950";" 1008253";"  896170";"    2697";"    1434";"     294";"     294";"       0";"       0"
"1029";"A043596";"2006MM01";"    1266";"     620";"     646";"   59245";"   30362";"   28883";"   59245";"   59245";"   58099";"       0";"       0";"       0";"       0";"       0";"       0"
"1030";"A043596";"2006MM02";"    1441";"     708";"     733";"   65936";"   31889";"   34047";"   65936";"   65803";"   64350";"     133";"       0";"     133";"     133";"       0";"       0"
"1031";"A043596";"2006MM03";"    1601";"     792";"     809";"   77003";"   38863";"   38140";"   77003";"   76990";"   75205";"      13";"       0";"      13";"       0";"       3";"      10"
"1032";"A043596";"2006KW01";"    4308";"    2120";"    2188";"  202184";"  101114";"  101070";"  202184";"  202038";"  197654";"     146";"       0";"     146";"     133";"       3";"      10"
"1033";"A043596";"2006MM04";"    1491";"     776";"     715";"   81270";"   38465";"   42805";"   81270";"   81270";"   78462";"       0";"       0";"       0";"       0";"       0";"       0"
"1034";"A043596";"2006MM05";"    1680";"     840";"     840";"  109259";"   53889";"   55370";"  109259";"  109259";"  100080";"       0";"       0";"       0";"       0";"       0";"       0"
"1035";"A043596";"2006MM06";"    1795";"     898";"     897";"  104614";"   52676";"   51938";"  104614";"  104614";"   96505";"       0";"       0";"       0";"       0";"       0";"       0"
"1036";"A043596";"2006KW02";"    4966";"    2514";"    2452";"  295143";"  145030";"  150113";"  295143";"  295143";"  275047";"       0";"       0";"       0";"       0";"       0";"       0"
"1037";"A043596";"2006MM07";"    1548";"     769";"     779";"  108013";"   49937";"   58076";"  108013";"  108013";"   96426";"       0";"       0";"       0";"       0";"       0";"       0"
"1038";"A043596";"2006MM08";"    1475";"     738";"     737";"  101757";"   55117";"   46640";"  101757";"  101757";"   92434";"       0";"       0";"       0";"       0";"       0";"       0"
"1039";"A043596";"2006MM09";"    1659";"     825";"     834";"  107184";"   52519";"   54665";"  107184";"  107184";"   98396";"       0";"       0";"       0";"       0";"       0";"       0"
"1040";"A043596";"2006KW03";"    4682";"    2332";"    2350";"  316954";"  157573";"  159381";"  316954";"  316954";"  287256";"       0";"       0";"       0";"       0";"       0";"       0"
"1041";"A043596";"2006MM10";"    1599";"     795";"     804";"   99344";"   52509";"   46835";"   99344";"   99344";"   90776";"       0";"       0";"       0";"       0";"       0";"       0"
"1042";"A043596";"2006MM11";"    1474";"     733";"     741";"   65245";"   33957";"   31288";"   65245";"   65245";"   64518";"       0";"       0";"       0";"       0";"       0";"       0"
"1043";"A043596";"2006MM12";"    1247";"     636";"     611";"   59101";"   27842";"   31259";"   59101";"   59101";"   57453";"       0";"       0";"       0";"       0";"       0";"       0"
"1044";"A043596";"2006KW04";"    4320";"    2164";"    2156";"  223690";"  114308";"  109382";"  223690";"  223690";"  212747";"       0";"       0";"       0";"       0";"       0";"       0"
"1045";"A043596";"2006JJ00";"   18276";"    9130";"    9146";" 1037971";"  518025";"  519946";" 1037971";" 1037825";"  972704";"     146";"       0";"     146";"     133";"       3";"      10"
"1046";"A043596";"2007MM01";"    1396";"     692";"     704";"   62559";"   32212";"   30347";"   62559";"   62549";"   59764";"      10";"       0";"       0";"       0";"       0";"       0"
"1047";"A043596";"2007MM02";"    1455";"     719";"     736";"   65654";"   31894";"   33760";"   65654";"   65626";"   62661";"      28";"       0";"       0";"       0";"       0";"       0"
"1048";"A043596";"2007MM03";"    1594";"     793";"     801";"   80082";"   40401";"   39681";"   80082";"   80082";"   76992";"       0";"       0";"       0";"       0";"       0";"       0"
"1049";"A043596";"2007KW01";"    4445";"    2204";"    2241";"  208295";"  104507";"  103788";"  208295";"  208257";"  199417";"      38";"       0";"       0";"       0";"       0";"       0"
"1050";"A043596";"2007MM04";"    1498";"     750";"     748";"   82050";"   38784";"   43266";"   82050";"   82050";"   80380";"       0";"       0";"       0";"       0";"       0";"       0"
"1051";"A043596";"2007MM05";"    1708";"     854";"     854";"  112235";"   55078";"   57157";"  112235";"  112235";"  103859";"       0";"       0";"       0";"       0";"       0";"       0"
"1052";"A043596";"2007MM06";"    1679";"     833";"     846";"  104900";"   52832";"   52068";"  104900";"  104900";"   98163";"       0";"       0";"       0";"       0";"       0";"       0"
"1053";"A043596";"2007KW02";"    4885";"    2437";"    2448";"  299185";"  146694";"  152491";"  299185";"  299185";"  282402";"       0";"       0";"       0";"       0";"       0";"       0"
"1054";"A043596";"2007MM07";"    1641";"     824";"     817";"  109236";"   50782";"   58454";"  109236";"  109236";"  100711";"       0";"       0";"       0";"       0";"       0";"       0"
"1055";"A043596";"2007MM08";"    1561";"     777";"     784";"  105835";"   56365";"   49470";"  105835";"  105835";"   97065";"       0";"       0";"       0";"       0";"       0";"       0"
"1056";"A043596";"2007MM09";"    1685";"     840";"     845";"  107548";"   52997";"   54551";"  107548";"  107548";"  100888";"       0";"       0";"       0";"       0";"       0";"       0"
"1057";"A043596";"2007KW03";"    4887";"    2441";"    2446";"  322619";"  160144";"  162475";"  322619";"  322619";"  298664";"       0";"       0";"       0";"       0";"       0";"       0"
"1058";"A043596";"2007MM10";"    1667";"     829";"     838";"  102419";"   54721";"   47698";"  102419";"  102419";"   95571";"       0";"       0";"       0";"       0";"       0";"       0"
"1059";"A043596";"2007MM11";"    1458";"     719";"     739";"   66496";"   34219";"   32277";"   66496";"   66402";"   66337";"      94";"       0";"       0";"       0";"       0";"       0"
"1060";"A043596";"2007MM12";"    1213";"     603";"     610";"   61030";"   29177";"   31853";"   61030";"   61030";"   59956";"       0";"       0";"       0";"       0";"       0";"       0"
"1061";"A043596";"2007KW04";"    4338";"    2151";"    2187";"  229945";"  118117";"  111828";"  229945";"  229851";"  221864";"      94";"       0";"       0";"       0";"       0";"       0"
"1062";"A043596";"2007JJ00";"   18555";"    9233";"    9322";" 1060044";"  529462";"  530582";" 1060044";" 1059912";" 1002347";"     132";"       0";"       0";"       0";"       0";"       0"
"1063";"A043596";"2008MM01";"    1383";"     688";"     695";"   67319";"   34094";"   33225";"   67319";"   67319";"   64616";"       0";"       0";"       0";"       0";"       0";"       0"
"1064";"A043596";"2008MM02";"    1427";"     709";"     718";"   67179";"   32648";"   34531";"   67179";"   67179";"   64567";"       0";"       0";"       0";"       0";"       0";"       0"
"1065";"A043596";"2008MM03";"    1574";"     778";"     796";"   82743";"   42668";"   40075";"   82743";"   82643";"   78096";"     100";"       0";"       0";"       0";"       0";"       0"
"1066";"A043596";"2008KW01";"    4384";"    2175";"    2209";"  217241";"  109410";"  107831";"  217241";"  217141";"  207279";"     100";"       0";"       0";"       0";"       0";"       0"
"1067";"A043596";"2008MM04";"    1595";"     801";"     794";"   78914";"   35584";"   43330";"   78914";"   78825";"   76299";"      89";"      89";"       0";"       0";"       0";"       0"
"1068";"A043596";"2008MM05";"    1497";"     749";"     748";"   95425";"   47951";"   47474";"   95425";"   95425";"   86349";"       0";"       0";"       0";"       0";"       0";"       0"
"1069";"A043596";"2008MM06";"    1708";"     853";"     855";"  100881";"   50299";"   50582";"  100881";"  100881";"   92193";"       0";"       0";"       0";"       0";"       0";"       0"
"1070";"A043596";"2008KW02";"    4800";"    2403";"    2397";"  275220";"  133834";"  141386";"  275220";"  275131";"  254841";"      89";"      89";"       0";"       0";"       0";"       0"
"1071";"A043596";"2008MM07";"    1595";"     800";"     795";"  104303";"   49388";"   54915";"  104303";"  104303";"   93611";"       0";"       0";"       0";"       0";"       0";"       0"
"1072";"A043596";"2008MM08";"    1438";"     716";"     722";"   98795";"   53654";"   45141";"   98795";"   98795";"   88265";"       0";"       0";"       0";"       0";"       0";"       0"
"1073";"A043596";"2008MM09";"    1609";"     810";"     799";"   98568";"   48454";"   50114";"   98568";"   98568";"   89419";"       0";"       0";"       0";"       0";"       0";"       0"
"1074";"A043596";"2008KW03";"    4642";"    2326";"    2316";"  301666";"  151496";"  150170";"  301666";"  301666";"  271295";"       0";"       0";"       0";"       0";"       0";"       0"
"1075";"A043596";"2008MM10";"    1503";"     750";"     753";"   87323";"   46767";"   40556";"   87323";"   87323";"   80011";"       0";"       0";"       0";"       0";"       0";"       0"
"1076";"A043596";"2008MM11";"    1063";"     533";"     530";"   50467";"   26478";"   23989";"   50467";"   50467";"   50388";"       0";"       0";"       0";"       0";"       0";"       0"
"1077";"A043596";"2008MM12";"    1055";"     527";"     528";"   54872";"   25655";"   29217";"   54872";"   54872";"   53286";"       0";"       0";"       0";"       0";"       0";"       0"
"1078";"A043596";"2008KW04";"    3621";"    1810";"    1811";"  192662";"   98900";"   93762";"  192662";"  192662";"  183685";"       0";"       0";"       0";"       0";"       0";"       0"
"1079";"A043596";"2008JJ00";"   17447";"    8714";"    8733";"  986789";"  493640";"  493149";"  986789";"  986600";"  917100";"     189";"      89";"       0";"       0";"       0";"       0"
"1080";"A043596";"2009MM01";"    1245";"     625";"     620";"   62337";"   31902";"   30435";"   62337";"   62337";"   59560";"       0";"       0";"       0";"       0";"       0";"       0"
"1081";"A043596";"2009MM02";"    1221";"     610";"     611";"   65242";"   32447";"   32795";"   65242";"   65241";"   62287";"       1";"       1";"       0";"       0";"       0";"       0"
"1082";"A043596";"2009MM03";"    1264";"     624";"     640";"   71683";"   37020";"   34663";"   71683";"   71683";"   68543";"       0";"       0";"       0";"       0";"       0";"       0"
"1083";"A043596";"2009KW01";"    3730";"    1859";"    1871";"  199262";"  101369";"   97893";"  199262";"  199261";"  190390";"       1";"       1";"       0";"       0";"       0";"       0"
"1084";"A043596";"2009MM04";"    1229";"     614";"     615";"   66876";"   30559";"   36317";"   66876";"   66676";"   64765";"     200";"       0";"       0";"       0";"       0";"       0"
"1085";"A043596";"2009MM05";"    1428";"     711";"     717";"   91441";"   45621";"   45820";"   91441";"   91232";"   83829";"     209";"     209";"       0";"       0";"       0";"       0"
"1086";"A043596";"2009MM06";"    1460";"     730";"     730";"   90848";"   45943";"   44905";"   90848";"   90848";"   82900";"       0";"       0";"       0";"       0";"       0";"       0"
"1087";"A043596";"2009KW02";"    4117";"    2055";"    2062";"  249165";"  122123";"  127042";"  249165";"  248756";"  231494";"     409";"     209";"       0";"       0";"       0";"       0"
"1088";"A043596";"2009MM07";"    1426";"     715";"     711";"   96901";"   44457";"   52444";"   96901";"   96901";"   88970";"       0";"       0";"       0";"       0";"       0";"       0"
"1089";"A043596";"2009MM08";"    1247";"     619";"     628";"   96528";"   52138";"   44390";"   96528";"   96528";"   87108";"       0";"       0";"       0";"       0";"       0";"       0"
"1090";"A043596";"2009MM09";"    1358";"     677";"     681";"   92751";"   46108";"   46643";"   92751";"   92751";"   84986";"       0";"       0";"       0";"       0";"       0";"       0"
"1091";"A043596";"2009KW03";"    4031";"    2011";"    2020";"  286180";"  142703";"  143477";"  286180";"  286180";"  261064";"       0";"       0";"       0";"       0";"       0";"       0"
"1092";"A043596";"2009MM10";"    1375";"     689";"     686";"   85598";"   45817";"   39781";"   85598";"   85515";"   78481";"      83";"       0";"       0";"       0";"       0";"       0"
"1093";"A043596";"2009MM11";"    1092";"     546";"     546";"   48318";"   25288";"   23030";"   48318";"   48236";"   47117";"      82";"       0";"       0";"       0";"       0";"       0"
"1094";"A043596";"2009MM12";"    1052";"     531";"     521";"   53317";"   24627";"   28690";"   53317";"   53317";"   51563";"       0";"       0";"       0";"       0";"       0";"       0"
"1095";"A043596";"2009KW04";"    3519";"    1766";"    1753";"  187233";"   95732";"   91501";"  187233";"  187068";"  177161";"     165";"       0";"       0";"       0";"       0";"       0"
"1096";"A043596";"2009JJ00";"   15397";"    7691";"    7706";"  921840";"  461927";"  459913";"  921840";"  921265";"  860109";"     575";"     210";"       0";"       0";"       0";"       0"
"1097";"A043596";"2010MM01";"    1169";"     580";"     589";"   59584";"   30537";"   29047";"   59584";"   59005";"   55853";"     579";"       0";"     579";"       0";"     318";"     261"
"1098";"A043596";"2010MM02";"    1104";"     551";"     553";"   62210";"   29903";"   32307";"   62210";"   62210";"   59312";"       0";"       0";"       0";"       0";"       0";"       0"
"1099";"A043596";"2010MM03";"    1246";"     623";"     623";"   72821";"   37539";"   35282";"   72821";"   72821";"   68872";"       0";"       0";"       0";"       0";"       0";"       0"
"1100";"A043596";"2010KW01";"    3519";"    1754";"    1765";"  194615";"   97979";"   96636";"  194615";"  194036";"  184037";"     579";"       0";"     579";"       0";"     318";"     261"
"1101";"A043596";"2010MM04";"     978";"     491";"     487";"   51759";"   23547";"   28212";"   51759";"   51759";"   49101";"       0";"       0";"       0";"       0";"       0";"       0"
"1102";"A043596";"2010MM05";"    1373";"     688";"     685";"   96812";"   46976";"   49836";"   96812";"   96812";"   85968";"       0";"       0";"       0";"       0";"       0";"       0"
"1103";"A043596";"2010MM06";"    1437";"     719";"     718";"   91026";"   47096";"   43930";"   91026";"   91026";"   81153";"       0";"       0";"       0";"       0";"       0";"       0"
"1104";"A043596";"2010KW02";"    3788";"    1898";"    1890";"  239597";"  117619";"  121978";"  239597";"  239597";"  216222";"       0";"       0";"       0";"       0";"       0";"       0"
"1105";"A043596";"2010MM07";"    1462";"     733";"     729";"  102749";"   46856";"   55893";"  102749";"  102049";"   87688";"     700";"       0";"       0";"       0";"       0";"       0"
"1106";"A043596";"2010MM08";"    1345";"     675";"     670";"  103361";"   56300";"   47061";"  103361";"  102519";"   89362";"     842";"       0";"       0";"       0";"       0";"       0"
"1107";"A043596";"2010MM09";"    1418";"     711";"     707";"  100099";"   49028";"   51071";"  100099";"   99696";"   89862";"     403";"       0";"       0";"       0";"       0";"       0"
"1108";"A043596";"2010KW03";"    4225";"    2119";"    2106";"  306209";"  152184";"  154025";"  306209";"  304264";"  266912";"    1945";"       0";"       0";"       0";"       0";"       0"
"1109";"A043596";"2010MM10";"    1314";"     657";"     657";"   90641";"   48536";"   42105";"   90641";"   90403";"   79094";"     238";"       0";"       0";"       0";"       0";"       0"
"1110";"A043596";"2010MM11";"     922";"     461";"     461";"   46200";"   24728";"   21472";"   46200";"   46148";"   45003";"      52";"       0";"       0";"       0";"       0";"       0"
"1111";"A043596";"2010MM12";"     875";"     445";"     430";"   45307";"   20794";"   24513";"   45307";"   44859";"   42790";"     448";"       0";"       0";"       0";"       0";"       0"
"1112";"A043596";"2010KW04";"    3111";"    1563";"    1548";"  182148";"   94058";"   88090";"  182148";"  181410";"  166887";"     738";"       0";"       0";"       0";"       0";"       0"
"1113";"A043596";"2010JJ00";"   14643";"    7334";"    7309";"  922569";"  461840";"  460729";"  922569";"  919307";"  834058";"    3262";"       0";"     579";"       0";"     318";"     261"
"1114";"A043596";"2011MM01";"    1032";"     507";"     525";"   55386";"   28274";"   27112";"   55386";"   55386";"   52809";"       0";"       0";"       0";"       0";"       0";"       0"
"1115";"A043596";"2011MM02";"    1095";"     546";"     549";"   59987";"   28896";"   31091";"   59987";"   59987";"   57542";"       0";"       0";"       0";"       0";"       0";"       0"
"1116";"A043596";"2011MM03";"    1177";"     588";"     589";"   74158";"   38266";"   35892";"   74158";"   74158";"   69683";"       0";"       0";"       0";"       0";"       0";"       0"
"1117";"A043596";"2011KW01";"    3304";"    1641";"    1663";"  189531";"   95436";"   94095";"  189531";"  189531";"  180034";"       0";"       0";"       0";"       0";"       0";"       0"
"1118";"A043596";"2011MM04";"    1111";"     559";"     552";"   70982";"   32679";"   38303";"   70982";"   70982";"   66335";"       0";"       0";"       0";"       0";"       0";"       0"
"1119";"A043596";"2011MM05";"    1510";"     754";"     756";"  112198";"   55129";"   57069";"  112198";"  112198";"  100465";"       0";"       0";"       0";"       0";"       0";"       0"
"1120";"A043596";"2011MM06";"    1452";"     722";"     730";"  113303";"   57180";"   56123";"  113303";"  112957";"  103439";"     346";"       0";"       0";"       0";"       0";"       0"
"1121";"A043596";"2011KW02";"    4073";"    2035";"    2038";"  296483";"  144988";"  151495";"  296483";"  296137";"  270239";"     346";"       0";"       0";"       0";"       0";"       0"
"1122";"A043596";"2011MM07";"    1412";"     701";"     711";"  126815";"   59745";"   67070";"  126815";"  126140";"  114106";"     675";"       0";"       0";"       0";"       0";"       0"
"1123";"A043596";"2011MM08";"    1360";"     677";"     683";"  120374";"   64557";"   55817";"  120374";"  120017";"  109719";"     357";"       0";"       0";"       0";"       0";"       0"
"1124";"A043596";"2011MM09";"    1493";"     754";"     739";"  116872";"   58817";"   58055";"  116872";"  116872";"  105353";"       0";"       0";"       0";"       0";"       0";"       0"
"1125";"A043596";"2011KW03";"    4265";"    2132";"    2133";"  364061";"  183119";"  180942";"  364061";"  363029";"  329178";"    1032";"       0";"       0";"       0";"       0";"       0"
"1126";"A043596";"2011MM10";"    1391";"     691";"     700";"  106423";"   56889";"   49534";"  106423";"  106423";"   96087";"       0";"       0";"       0";"       0";"       0";"       0"
"1127";"A043596";"2011MM11";"     921";"     460";"     461";"   55243";"   28614";"   26629";"   55243";"   55243";"   54145";"       0";"       0";"       0";"       0";"       0";"       0"
"1128";"A043596";"2011MM12";"     994";"     497";"     497";"   63461";"   29614";"   33847";"   63461";"   63199";"   62023";"     262";"       0";"       0";"       0";"       0";"       0"
"1129";"A043596";"2011KW04";"    3306";"    1648";"    1658";"  225127";"  115117";"  110010";"  225127";"  224865";"  212255";"     262";"       0";"       0";"       0";"       0";"       0"
"1130";"A043596";"2011JJ00";"   14948";"    7456";"    7492";" 1075202";"  538660";"  536542";" 1075202";" 1073562";"  991706";"    1640";"       0";"       0";"       0";"       0";"       0"
"1131";"A043596";"2012MM01";"    1153";"     573";"     580";"   75066";"   38593";"   36473";"   75066";"   75066";"   72628";"       0";"       0";"       0";"       0";"       0";"       0"
"1132";"A043596";"2012MM02";"    1159";"     577";"     582";"   78132";"   37891";"   40241";"   78132";"   77992";"   75711";"     140";"       0";"       0";"       0";"       0";"       0"
"1133";"A043596";"2012MM03";"    1245";"     619";"     626";"   91418";"   47043";"   44375";"   91418";"   91418";"   88258";"       0";"       0";"       0";"       0";"       0";"       0"
"1134";"A043596";"2012KW01";"    3557";"    1769";"    1788";"  244616";"  123527";"  121089";"  244616";"  244476";"  236597";"     140";"       0";"       0";"       0";"       0";"       0"
"1135";"A043596";"2012MM04";"    1116";"     555";"     561";"   81633";"   38950";"   42683";"   81633";"   81633";"   77984";"       0";"       0";"       0";"       0";"       0";"       0"
"1136";"A043596";"2012MM05";"    1485";"     741";"     744";"  121917";"   59897";"   62020";"  121917";"  121917";"  110040";"       0";"       0";"       0";"       0";"       0";"       0"
"1137";"A043596";"2012MM06";"    1444";"     720";"     724";"  118269";"   59390";"   58879";"  118269";"  117134";"  105276";"    1135";"       0";"       0";"       0";"       0";"       0"
"1138";"A043596";"2012KW02";"    4045";"    2016";"    2029";"  321819";"  158237";"  163582";"  321819";"  320684";"  293300";"    1135";"       0";"       0";"       0";"       0";"       0"
"1139";"A043596";"2012MM07";"    1465";"     735";"     730";"  130946";"   61128";"   69818";"  130946";"  129979";"  115874";"     967";"       0";"       0";"       0";"       0";"       0"
"1140";"A043596";"2012MM08";"    1435";"     736";"     699";"  130966";"   70158";"   60808";"  130966";"  130365";"  117322";"     601";"       0";"       0";"       0";"       0";"       0"
"1141";"A043596";"2012MM09";"    1397";"     701";"     696";"  123655";"   62143";"   61512";"  123655";"  123171";"  111367";"     484";"       0";"       0";"       0";"       0";"       0"
"1142";"A043596";"2012KW03";"    4297";"    2172";"    2125";"  385567";"  193429";"  192138";"  385567";"  383515";"  344563";"    2052";"       0";"       0";"       0";"       0";"       0"
"1143";"A043596";"2012MM10";"    1458";"     725";"     733";"  117840";"   62116";"   55724";"  117840";"  117833";"  105710";"       7";"       0";"       0";"       0";"       0";"       0"
"1144";"A043596";"2012MM11";"     923";"     460";"     463";"   54121";"   28368";"   25753";"   54121";"   54121";"   53097";"       0";"       0";"       0";"       0";"       0";"       0"
"1145";"A043596";"2012MM12";"     965";"     483";"     482";"   62576";"   28657";"   33919";"   62576";"   62576";"   61283";"       0";"       0";"       0";"       0";"       0";"       0"
"1146";"A043596";"2012KW04";"    3346";"    1668";"    1678";"  234537";"  119141";"  115396";"  234537";"  234530";"  220090";"       7";"       0";"       0";"       0";"       0";"       0"
"1147";"A043596";"2012JJ00";"   15245";"    7625";"    7620";" 1186539";"  594334";"  592205";" 1186539";" 1183205";" 1094550";"    3334";"       0";"       0";"       0";"       0";"       0"
"1148";"A043596";"2013MM01";"    1325";"     660";"     665";"   84234";"   43113";"   41121";"   84234";"   84234";"   81527";"       0";"       0";"       0";"       0";"       0";"       0"
"1149";"A043596";"2013MM02";"    1273";"     638";"     635";"   90438";"   43511";"   46927";"   90438";"   90438";"   87606";"       0";"       0";"       0";"       0";"       0";"       0"
"1150";"A043596";"2013MM03";"    1465";"     728";"     737";"  110486";"   56437";"   54049";"  110486";"  110486";"  107102";"       0";"       0";"       0";"       0";"       0";"       0"
"1151";"A043596";"2013KW01";"    4063";"    2026";"    2037";"  285158";"  143061";"  142097";"  285158";"  285158";"  276235";"       0";"       0";"       0";"       0";"       0";"       0"
"1152";"A043596";"2013MM04";"    1502";"     750";"     752";"  110862";"   52501";"   58361";"  110862";"  110862";"  103825";"       0";"       0";"       0";"       0";"       0";"       0"
"1153";"A043596";"2013MM05";"    1855";"     919";"     936";"  160404";"   79382";"   81022";"  160404";"  160404";"  145199";"       0";"       0";"       0";"       0";"       0";"       0"
"1154";"A043596";"2013MM06";"    1796";"     894";"     902";"  155446";"   77440";"   78006";"  155446";"  154921";"  140221";"     525";"       0";"       0";"       0";"       0";"       0"
"1155";"A043596";"2013KW02";"    5153";"    2563";"    2590";"  426712";"  209323";"  217389";"  426712";"  426187";"  389245";"     525";"       0";"       0";"       0";"       0";"       0"
"1156";"A043596";"2013MM07";"    1817";"     910";"     907";"  154817";"   72390";"   82427";"  154817";"  152036";"  136877";"    2781";"       0";"       0";"       0";"       0";"       0"
"1157";"A043596";"2013MM08";"    1683";"     831";"     852";"  155270";"   81355";"   73915";"  155270";"  150615";"  131913";"    4655";"       0";"       0";"       0";"       0";"       0"
"1158";"A043596";"2013MM09";"    1854";"     923";"     931";"  161155";"   82165";"   78990";"  161155";"  159247";"  143687";"    1908";"       0";"       0";"       0";"       0";"       0"
"1159";"A043596";"2013KW03";"    5354";"    2664";"    2690";"  471242";"  235910";"  235332";"  471242";"  461898";"  412477";"    9344";"       0";"       0";"       0";"       0";"       0"
"1160";"A043596";"2013MM10";"    1679";"     835";"     844";"  136930";"   72111";"   64819";"  136930";"  135335";"  123325";"    1595";"       0";"       0";"       0";"       0";"       0"
"1161";"A043596";"2013MM11";"    1255";"     625";"     630";"   81945";"   42700";"   39245";"   81945";"   79326";"   75991";"    2619";"       2";"       0";"       0";"       0";"       0"
"1162";"A043596";"2013MM12";"    1155";"     577";"     578";"   86585";"   40472";"   46113";"   86585";"   84825";"   80779";"    1760";"       0";"       0";"       0";"       0";"       0"
"1163";"A043596";"2013KW04";"    4089";"    2037";"    2052";"  305460";"  155283";"  150177";"  305460";"  299486";"  280095";"    5974";"       2";"       0";"       0";"       0";"       0"
"1164";"A043596";"2013JJ00";"   18659";"    9290";"    9369";" 1488572";"  743577";"  744995";" 1488572";" 1472729";" 1358052";"   15843";"       2";"       0";"       0";"       0";"       0"
"1165";"A043596";"2014MM01";"    1345";"     668";"     677";"   94277";"   48725";"   45552";"   94277";"   92784";"   87089";"    1493";"       0";"      71";"      71";"       0";"       0"
"1166";"A043596";"2014MM02";"    1358";"     675";"     683";"  106528";"   51772";"   54756";"  106528";"  104768";"   97748";"    1760";"       0";"       0";"       0";"       0";"       0"
"1167";"A043596";"2014MM03";"    1614";"     796";"     818";"  135230";"   69576";"   65654";"  135230";"  132109";"  119066";"    3121";"       0";"       0";"       0";"       0";"       0"
"1168";"A043596";"2014KW01";"    4317";"    2139";"    2178";"  336035";"  170073";"  165962";"  336035";"  329661";"  303903";"    6374";"       0";"      71";"      71";"       0";"       0"
"1169";"A043596";"2014MM04";"    1556";"     775";"     781";"  135401";"   63337";"   72064";"  135401";"  131975";"  122327";"    3426";"       0";"       0";"       0";"       0";"       0"
"1170";"A043596";"2014MM05";"    1802";"     899";"     903";"  171860";"   85735";"   86125";"  171860";"  169682";"  153899";"    2178";"       0";"       0";"       0";"       0";"       0"
"1171";"A043596";"2014MM06";"    1822";"     907";"     915";"  169860";"   86198";"   83662";"  169860";"  169640";"  155334";"     220";"       0";"       0";"       0";"       0";"       0"
"1172";"A043596";"2014KW02";"    5180";"    2581";"    2599";"  477121";"  235270";"  241851";"  477121";"  471297";"  431560";"    5824";"       0";"       0";"       0";"       0";"       0"
"1173";"A043596";"2014MM07";"    1725";"     862";"     863";"  147262";"   67043";"   80219";"  147262";"  144796";"  129975";"    2466";"      96";"     240";"     240";"       0";"       0"
"1174";"A043596";"2014MM08";"    1581";"     778";"     803";"  153111";"   80810";"   72301";"  153111";"  149026";"  128995";"    4085";"       0";"    1261";"    1261";"       0";"       0"
"1175";"A043596";"2014MM09";"    1891";"     949";"     942";"  175449";"   88864";"   86585";"  175449";"  173494";"  156038";"    1955";"       0";"       0";"       0";"       0";"       0"
"1176";"A043596";"2014KW03";"    5197";"    2589";"    2608";"  475822";"  236717";"  239105";"  475822";"  467316";"  415008";"    8506";"      96";"    1501";"    1501";"       0";"       0"
"1177";"A043596";"2014MM10";"    1701";"     843";"     858";"  158138";"   83232";"   74906";"  158138";"  156860";"  141031";"    1278";"       0";"       0";"       0";"       0";"       0"
"1178";"A043596";"2014MM11";"    1173";"     584";"     589";"   82604";"   43055";"   39549";"   82604";"   82604";"   75948";"       0";"       0";"       0";"       0";"       0";"       0"
"1179";"A043596";"2014MM12";"    1222";"     618";"     604";"   95157";"   44167";"   50990";"   95157";"   94708";"   86083";"     449";"       0";"       0";"       0";"       0";"       0"
"1180";"A043596";"2014KW04";"    4096";"    2045";"    2051";"  335899";"  170454";"  165445";"  335899";"  334172";"  303062";"    1727";"       0";"       0";"       0";"       0";"       0"
"1181";"A043596";"2014JJ00";"   18790";"    9354";"    9436";" 1624877";"  812514";"  812363";" 1624877";" 1602446";" 1453533";"   22431";"      96";"    1572";"    1572";"       0";"       0"
"1182";"A043596";"2015MM01";"    1144";"     570";"     574";"   84735";"   43775";"   40960";"   84735";"   84582";"   76352";"     153";"       0";"       0";"       0";"       0";"       0"
"1183";"A043596";"2015MM02";"    1263";"     632";"     631";"  102424";"   49394";"   53030";"  102424";"  101790";"   94371";"     634";"       0";"       0";"       0";"       0";"       0"
"1184";"A043596";"2015MM03";"    1530";"     766";"     764";"  126737";"   65385";"   61352";"  126737";"  125849";"  116430";"     888";"       0";"       0";"       0";"       0";"       0"
"1185";"A043596";"2015KW01";"    3937";"    1968";"    1969";"  313896";"  158554";"  155342";"  313896";"  312221";"  287153";"    1675";"       0";"       0";"       0";"       0";"       0"
"1186";"A043596";"2015MM04";"    1629";"     816";"     813";"  134281";"   62045";"   72236";"  134281";"  131289";"  121690";"    2992";"       0";"       0";"       0";"       0";"       0"
"1187";"A043596";"2015MM05";"    1958";"     975";"     983";"  190641";"   95368";"   95273";"  190641";"  187591";"  169241";"    3050";"       0";"       0";"       0";"       0";"       0"
"1188";"A043596";"2015MM06";"    1991";"     996";"     995";"  180298";"   90135";"   90163";"  180298";"  177952";"  162599";"    2346";"       0";"       0";"       0";"       0";"       0"
"1189";"A043596";"2015KW02";"    5578";"    2787";"    2791";"  505220";"  247548";"  257672";"  505220";"  496832";"  453530";"    8388";"       0";"       0";"       0";"       0";"       0"
"1190";"A043596";"2015MM07";"    1781";"     886";"     895";"  155964";"   70204";"   85760";"  155964";"  152700";"  132953";"    3264";"       0";"      25";"      25";"       0";"       0"
"1191";"A043596";"2015MM08";"    1688";"     840";"     848";"  163847";"   88826";"   75021";"  163847";"  159100";"  136222";"    4747";"       0";"       0";"       0";"       0";"       0"
"1192";"A043596";"2015MM09";"    1950";"     977";"     973";"  178517";"   90050";"   88467";"  178517";"  175359";"  159628";"    3158";"       0";"       0";"       0";"       0";"       0"
"1193";"A043596";"2015KW03";"    5419";"    2703";"    2716";"  498328";"  249080";"  249248";"  498328";"  487159";"  428803";"   11169";"       0";"      25";"      25";"       0";"       0"
"1194";"A043596";"2015MM10";"    1738";"     861";"     877";"  152978";"   80438";"   72540";"  152978";"  150170";"  135717";"    2808";"       0";"       0";"       0";"       0";"       0"
"1195";"A043596";"2015MM11";"    1223";"     611";"     612";"   85191";"   45535";"   39656";"   85191";"   85191";"   80280";"       0";"       0";"       0";"       0";"       0";"       0"
"1196";"A043596";"2015MM12";"    1127";"     569";"     558";"   83770";"   39679";"   44091";"   83770";"   83466";"   77975";"     304";"       0";"       0";"       0";"       0";"       0"
"1197";"A043596";"2015KW04";"    4088";"    2041";"    2047";"  321939";"  165652";"  156287";"  321939";"  318827";"  293972";"    3112";"       0";"       0";"       0";"       0";"       0"
"1198";"A043596";"2015JJ00";"   19022";"    9499";"    9523";" 1639383";"  820834";"  818549";" 1639383";" 1615039";" 1463458";"   24344";"       0";"      25";"      25";"       0";"       0"
"1199";"A043596";"2016MM01";"    1164";"     576";"     588";"   88519";"   45699";"   42820";"   88519";"   87969";"   80711";"     550";"       0";"       0";"       0";"       0";"       0"
"1200";"A043596";"2016MM02";"    1399";"     698";"     701";"  106972";"   52229";"   54743";"  106972";"  106516";"   99714";"     456";"       0";"       0";"       0";"       0";"       0"
"1201";"A043596";"2016MM03";"    1607";"     804";"     803";"  127991";"   64426";"   63565";"  127991";"  127670";"  119517";"     321";"       0";"       0";"       0";"       0";"       0"
"1202";"A043596";"2016KW01";"    4170";"    2078";"    2092";"  323482";"  162354";"  161128";"  323482";"  322155";"  299942";"    1327";"       0";"       0";"       0";"       0";"       0"
"1203";"A043596";"2016MM04";"    1646";"     822";"     824";"  138051";"   63706";"   74345";"  138051";"  135060";"  126652";"    2991";"       0";"       0";"       0";"       0";"       0"
"1204";"A043596";"2016MM05";"    1909";"     949";"     960";"  184418";"   93465";"   90953";"  184418";"  181699";"  169045";"    2719";"       0";"       0";"       0";"       0";"       0"
"1205";"A043596";"2016MM06";"    1867";"     927";"     940";"  176708";"   87930";"   88778";"  176708";"  174172";"  165674";"    2536";"       0";"       0";"       0";"       0";"       0"
"1206";"A043596";"2016KW02";"    5422";"    2698";"    2724";"  499177";"  245101";"  254076";"  499177";"  490931";"  461371";"    8246";"       0";"       0";"       0";"       0";"       0"
"1207";"A043596";"2016MM07";"    1765";"     882";"     883";"  162493";"   74515";"   87978";"  162493";"  159890";"  144552";"    2603";"       0";"       0";"       0";"       0";"       0"
"1208";"A043596";"2016MM08";"    1723";"     859";"     864";"  161398";"   85739";"   75659";"  161398";"  158747";"  141981";"    2651";"       0";"       0";"       0";"       0";"       0"
"1209";"A043596";"2016MM09";"    1872";"     928";"     944";"  168984";"   85312";"   83672";"  168984";"  166351";"  157894";"    2633";"       0";"       0";"       0";"       0";"       0"
"1210";"A043596";"2016KW03";"    5360";"    2669";"    2691";"  492875";"  245566";"  247309";"  492875";"  484988";"  444427";"    7887";"       0";"       0";"       0";"       0";"       0"
"1211";"A043596";"2016MM10";"    1718";"     857";"     861";"  142815";"   74663";"   68152";"  142815";"  140076";"  132747";"    2739";"       0";"       0";"       0";"       0";"       0"
"1212";"A043596";"2016MM11";"    1213";"     607";"     606";"   93856";"   48098";"   45758";"   93856";"   93806";"   93515";"      50";"       0";"       0";"       0";"       0";"       0"
"1213";"A043596";"2016MM12";"    1172";"     583";"     589";"   91788";"   42944";"   48844";"   91788";"   91738";"   90712";"      50";"       0";"      50";"      50";"       0";"       0"
"1214";"A043596";"2016KW04";"    4103";"    2047";"    2056";"  328459";"  165705";"  162754";"  328459";"  325620";"  316974";"    2839";"       0";"      50";"      50";"       0";"       0"
"1215";"A043596";"2016JJ00";"   19055";"    9492";"    9563";" 1643993";"  818726";"  825267";" 1643993";" 1623694";" 1522714";"   20299";"       0";"      50";"      50";"       0";"       0"
"1216";"A043596";"2017MM01";"    1179";"     586";"     593";"   99803";"   50465";"   49338";"   99803";"   99803";"   98685";"       0";"       0";"       0";"       0";"       0";"       0"
"1217";"A043596";"2017MM02";"    1167";"     587";"     580";"  100103";"   47975";"   52128";"  100103";"  100034";"   98314";"      69";"       0";"       1";"       1";"       0";"       0"
"1218";"A043596";"2017MM03";"    1327";"     655";"     672";"  121428";"   62047";"   59381";"  121428";"  121329";"  118857";"      99";"       0";"       0";"       0";"       0";"       0"
"1219";"A043596";"2017KW01";"    3673";"    1828";"    1845";"  321334";"  160487";"  160847";"  321334";"  321166";"  315856";"     168";"       0";"       1";"       1";"       0";"       0"
"1220";"A043596";"2017MM04";"    1434";"     723";"     711";"  153870";"   72466";"   81404";"  153870";"  148860";"  147841";"    5010";"       0";"       0";"       0";"       0";"       0"
"1221";"A043596";"2017MM05";"    1718";"     856";"     862";"  190720";"   95023";"   95697";"  190720";"  185839";"  183923";"    4881";"       0";"       0";"       0";"       0";"       0"
"1222";"A043596";"2017MM06";"    1597";"     792";"     805";"  186491";"   92354";"   94137";"  186491";"  183160";"  181265";"    3331";"       0";"       0";"       0";"       0";"       0"
"1223";"A043596";"2017KW02";"    4749";"    2371";"    2378";"  531081";"  259843";"  271238";"  531081";"  517859";"  513029";"   13222";"       0";"       0";"       0";"       0";"       0"
"1224";"A043596";"2017MM07";"    1575";"     781";"     794";"  193211";"   89801";"  103410";"  193211";"  186801";"  183153";"    6410";"       0";"       0";"       0";"       0";"       0"
"1225";"A043596";"2017MM08";"    1564";"     779";"     785";"  195301";"  102032";"   93269";"  195301";"  187308";"  182684";"    7993";"       0";"       0";"       0";"       0";"       0"
"1226";"A043596";"2017MM09";"    1536";"     765";"     771";"  188847";"   95455";"   93392";"  188847";"  184290";"  182183";"    4557";"       0";"       0";"       0";"       0";"       0"
"1227";"A043596";"2017KW03";"    4675";"    2325";"    2350";"  577359";"  287288";"  290071";"  577359";"  558399";"  548020";"   18960";"       0";"       0";"       0";"       0";"       0"
"1228";"A043596";"2017MM10";"    1473";"     731";"     742";"  157992";"   82035";"   75957";"  157992";"  154210";"  152400";"    3782";"       0";"       0";"       0";"       0";"       0"
"1229";"A043596";"2017MM11";"     848";"     421";"     427";"   70941";"   37052";"   33889";"   70941";"   67360";"   67175";"    3581";"     310";"      56";"      56";"       0";"       0"
"1230";"A043596";"2017MM12";"     852";"     423";"     429";"   73985";"   34776";"   39209";"   73985";"   72207";"   70808";"    1778";"       0";"     166";"     166";"       0";"       0"
"1231";"A043596";"2017KW04";"    3173";"    1575";"    1598";"  302918";"  153863";"  149055";"  302918";"  293777";"  290383";"    9141";"     310";"     222";"     222";"       0";"       0"
"1232";"A043596";"2017JJ00";"   16270";"    8099";"    8171";" 1732692";"  861481";"  871211";" 1732692";" 1691201";" 1667288";"   41491";"     310";"     223";"     223";"       0";"       0"
"1233";"A043596";"2018MM01";"     988";"     493";"     495";"   89021";"   45124";"   43897";"   89021";"   86830";"   85192";"    2191";"     640";"       0";"       0";"       0";"       0"
"1234";"A043596";"2018MM02";"     988";"     498";"     490";"   88493";"   42614";"   45879";"   88493";"   87155";"   85499";"    1338";"       0";"       0";"       0";"       0";"       0"
"1235";"A043596";"2018MM03";"    1198";"     597";"     601";"  121533";"   61646";"   59887";"  121533";"  119180";"  115953";"    2353";"       0";"     193";"     193";"       0";"       0"
"1236";"A043596";"2018KW01";"    3174";"    1588";"    1586";"  299047";"  149384";"  149663";"  299047";"  293165";"  286644";"    5882";"     640";"     193";"     193";"       0";"       0"
"1237";"A043596";"2018MM04";"    1461";"     733";"     728";"  144208";"   66040";"   78168";"  144208";"  139027";"  132736";"    5181";"       0";"       0";"       0";"       0";"       0"
"1238";"A043596";"2018MM05";"    1964";"     971";"     993";"  221150";"  109712";"  111438";"  221150";"  216789";"  205776";"    4361";"       0";"       0";"       0";"       0";"       0"
"1239";"A043596";"2018MM06";"    1921";"     953";"     968";"  217739";"  107243";"  110496";"  217739";"  213558";"  207936";"    4181";"       0";"       0";"       0";"       0";"       0"
"1240";"A043596";"2018KW02";"    5346";"    2657";"    2689";"  583097";"  282995";"  300102";"  583097";"  569374";"  546448";"   13723";"       0";"       0";"       0";"       0";"       0"
"1241";"A043596";"2018MM07";"    1897";"     951";"     946";"  230635";"  106713";"  123922";"  230635";"  223614";"  212897";"    7021";"     251";"     740";"     740";"       0";"       0"
"1242";"A043596";"2018MM08";"    1864";"     924";"     940";"  232799";"  122246";"  110553";"  232799";"  226649";"  211885";"    6150";"       0";"     786";"     786";"       0";"       0"
"1243";"A043596";"2018MM09";"    1879";"     939";"     940";"  223027";"  112043";"  110984";"  223027";"  217909";"  211607";"    5118";"       0";"     154";"     154";"       0";"       0"
"1244";"A043596";"2018KW03";"    5640";"    2814";"    2826";"  686461";"  341002";"  345459";"  686461";"  668172";"  636389";"   18289";"     251";"    1680";"    1680";"       0";"       0"
"1245";"A043596";"2018MM10";"    1763";"     877";"     886";"  193930";"  102562";"   91368";"  193930";"  187049";"  177580";"    6881";"       0";"       0";"       0";"       0";"       0"
"1246";"A043596";"2018MM11";"     884";"     440";"     444";"   73245";"   37959";"   35286";"   73245";"   69196";"   68985";"    4049";"       0";"       0";"       0";"       0";"       0"
"1247";"A043596";"2018MM12";"     808";"     402";"     406";"   72378";"   33519";"   38859";"   72378";"   68617";"   65555";"    3761";"       0";"       0";"       0";"       0";"       0"
"1248";"A043596";"2018KW04";"    3455";"    1719";"    1736";"  339553";"  174040";"  165513";"  339553";"  324862";"  312120";"   14691";"       0";"       0";"       0";"       0";"       0"
"1249";"A043596";"2018JJ00";"   17615";"    8778";"    8837";" 1908158";"  947421";"  960737";" 1908158";" 1855573";" 1781601";"   52585";"     891";"    1873";"    1873";"       0";"       0"
"1250";"A043596";"2019MM01";"     938";"     471";"     467";"   84056";"   42870";"   41186";"   84056";"   79966";"   75090";"    4090";"       0";"     476";"     476";"       0";"       0"
"1251";"A043596";"2019MM02";"     978";"     491";"     487";"   95420";"   45623";"   49797";"   95420";"   91161";"   83748";"    4259";"       0";"       0";"       0";"       0";"       0"
"1252";"A043596";"2019MM03";"    1286";"     642";"     644";"  137683";"   70235";"   67448";"  137683";"  130992";"  121959";"    6691";"       0";"       0";"       0";"       0";"       0"
"1253";"A043596";"2019KW01";"    3202";"    1604";"    1598";"  317159";"  158728";"  158431";"  317159";"  302119";"  280797";"   15040";"       0";"     476";"     476";"       0";"       0"
"1254";"A043596";"2019MM04";"    1556";"     782";"     774";"  169142";"   77152";"   91990";"  169142";"  159234";"  150456";"    9908";"       0";"       0";"       0";"       0";"       0"
"1255";"A043596";"2019MM05";"    2011";"    1000";"    1011";"  227437";"  112360";"  115077";"  227437";"  221218";"  209625";"    6219";"       0";"       0";"       0";"       0";"       0"
"1256";"A043596";"2019MM06";"    1943";"     974";"     969";"  240069";"  118538";"  121531";"  240069";"  231448";"  218310";"    8621";"       0";"       0";"       0";"       0";"       0"
"1257";"A043596";"2019KW02";"    5510";"    2756";"    2754";"  636648";"  308050";"  328598";"  636648";"  611900";"  578391";"   24748";"       0";"       0";"       0";"       0";"       0"
"1258";"A043596";"2019MM07";"    2039";"    1017";"    1022";"  251074";"  113281";"  137793";"  251074";"  238037";"  217858";"   13037";"       0";"       0";"       0";"       0";"       0"
"1259";"A043596";"2019MM08";"    2099";"    1045";"    1054";"  269858";"  142244";"  127614";"  269858";"  252335";"  224553";"   17523";"       0";"     165";"     165";"       0";"       0"
"1260";"A043596";"2019MM09";"    1997";"    1003";"     994";"  240606";"  122672";"  117934";"  240606";"  229982";"  215278";"   10624";"       0";"       0";"       0";"       0";"       0"
"1261";"A043596";"2019KW03";"    6135";"    3065";"    3070";"  761538";"  378197";"  383341";"  761538";"  720354";"  657689";"   41184";"       0";"     165";"     165";"       0";"       0"
"1262";"A043596";"2019MM10";"    1771";"     885";"     886";"  198592";"  107016";"   91576";"  198592";"  187377";"  174085";"   11215";"       0";"       0";"       0";"       0";"       0"
"1263";"A043596";"2019MM11";"     910";"     454";"     456";"   91748";"   48123";"   43625";"   91748";"   83215";"   76334";"    8533";"       0";"       0";"       0";"       0";"       0"
"1264";"A043596";"2019MM12";"     878";"     439";"     439";"   89113";"   41797";"   47316";"   89113";"   81414";"   73012";"    7699";"       0";"       0";"       0";"       0";"       0"
"1265";"A043596";"2019KW04";"    3559";"    1778";"    1781";"  379453";"  196936";"  182517";"  379453";"  352006";"  323431";"   27447";"       0";"       0";"       0";"       0";"       0"
"1266";"A043596";"2019JJ00";"   18406";"    9203";"    9203";" 2094798";" 1041911";" 1052887";" 2094798";" 1986379";" 1840308";"  108419";"       0";"     641";"     641";"       0";"       0"
"1267";"A043596";"2020MM01";"     963";"     481";"     482";"   99080";"   51119";"   47961";"   99080";"   90361";"   82120";"    8719";"       0";"       0";"       0";"       0";"       0"
"1268";"A043596";"2020MM02";"    1031";"     506";"     525";"  104062";"   49988";"   54074";"  104062";"   97069";"   88934";"    6993";"       0";"       0";"       0";"       0";"       0"
"1269";"A043596";"2020MM03";"     748";"     369";"     379";"   62870";"   36664";"   26206";"   62870";"   57788";"   53433";"    5082";"       0";"       0";"       0";"       0";"       0"
"1270";"A043596";"2020KW01";"    2742";"    1356";"    1386";"  266012";"  137771";"  128241";"  266012";"  245218";"  224487";"   20794";"       0";"       0";"       0";"       0";"       0"
"1271";"A043596";"2020MM04";"      41";"      17";"      24";"       0";"       0";"       0";"       0";"       0";"       0";"       0";"       0";"       0";"       0";"       0";"       0"
"1272";"A043596";"2020MM05";"      46";"      19";"      27";"     134";"      78";"      56";"     134";"     134";"     134";"       0";"       0";"       0";"       0";"       0";"       0"
"1273";"A043596";"2020MM06";"     168";"      80";"      88";"    7971";"    2072";"    5899";"    7971";"    7971";"    7041";"       0";"       0";"       0";"       0";"       0";"       0"
"1274";"A043596";"2020KW02";"     255";"     116";"     139";"    8105";"    2150";"    5955";"    8105";"    8105";"    7175";"       0";"       0";"       0";"       0";"       0";"       0"
"1275";"A043596";"2020MM07";"    1032";"     522";"     510";"   78468";"   32511";"   45957";"   78468";"   78468";"   74671";"       0";"       0";"       0";"       0";"       0";"       0"
"1276";"A043596";"2020MM08";"    1071";"     527";"     544";"   74047";"   41749";"   32298";"   74047";"   74047";"   68565";"       0";"       0";"       0";"       0";"       0";"       0"
"1277";"A043596";"2020MM09";"     635";"     315";"     320";"   32047";"   17087";"   14960";"   32047";"   31135";"   29077";"     912";"       0";"       0";"       0";"       0";"       0"
"1278";"A043596";"2020KW03";"    2738";"    1364";"    1374";"  184562";"   91347";"   93215";"  184562";"  183650";"  172313";"     912";"       0";"       0";"       0";"       0";"       0"
"1279";"A043596";"2020MM10";"     353";"     176";"     177";"   21811";"   11445";"   10366";"   21811";"   19216";"   19168";"    2595";"       0";"       0";"       0";"       0";"       0"
"1280";"A043596";"2020MM11";"     134";"      62";"      72";"    4761";"    2639";"    2122";"    4761";"    2365";"    2176";"    2396";"       0";"       0";"       0";"       0";"       0"
"1281";"A043596";"2020MM12";"     115";"      63";"      52";"    4590";"    1940";"    2650";"    4590";"     325";"     325";"    4265";"       0";"       0";"       0";"       0";"       0"
"1282";"A043596";"2020KW04";"     602";"     301";"     301";"   31162";"   16024";"   15138";"   31162";"   21906";"   21669";"    9256";"       0";"       0";"       0";"       0";"       0"
"1283";"A043596";"2020JJ00";"    6337";"    3137";"    3200";"  489841";"  247292";"  242549";"  489841";"  458879";"  425644";"   30962";"       0";"       0";"       0";"       0";"       0"
"1284";"A043596";"2021MM01";"     181";"      83";"      98";"    3311";"    2053";"    1258";"    3311";"      34";"       0";"    3277";"       0";"       0";"       0";"       0";"       0"
"1285";"A043596";"2021MM02";"     144";"      74";"      70";"    2871";"    1508";"    1363";"    2871";"       0";"       0";"    2871";"       0";"       0";"       0";"       0";"       0"
"1286";"A043596";"2021MM03";"     185";"      88";"      97";"      98";"      57";"      41";"      98";"      98";"      98";"       0";"       0";"       0";"       0";"       0";"       0"
"1287";"A043596";"2021KW01";"     510";"     245";"     265";"    6280";"    3618";"    2662";"    6280";"     132";"      98";"    6148";"       0";"       0";"       0";"       0";"       0"
"1288";"A043596";"2021MM04";"     195";"     100";"      95";"    1945";"     642";"    1303";"    1945";"    1945";"    1166";"       0";"       0";"       0";"       0";"       0";"       0"
"1289";"A043596";"2021MM05";"     267";"     132";"     135";"    8912";"    4045";"    4867";"    8912";"    8912";"    8162";"       0";"       0";"       0";"       0";"       0";"       0"
"1290";"A043596";"2021MM06";"     579";"     289";"     290";"   39309";"   15981";"   23328";"   39309";"   33826";"   32653";"    5483";"       0";"       0";"       0";"       0";"       0"
"1291";"A043596";"2021KW02";"    1041";"     521";"     520";"   50166";"   20668";"   29498";"   50166";"   44683";"   41981";"    5483";"       0";"       0";"       0";"       0";"       0"
"1292";"A043596";"2021MM07";"    1312";"     666";"     646";"  113882";"   45390";"   68492";"  113882";"   98923";"   91688";"   14959";"       0";"       0";"       0";"       0";"       0"
"1293";"A043596";"2021MM08";"    1516";"     749";"     767";"  181957";"   98121";"   83836";"  181957";"  164739";"  155694";"   17218";"       0";"       0";"       0";"       0";"       0"
"1294";"A043596";"2021MM09";"    1410";"     706";"     704";"  167169";"   84608";"   82561";"  167169";"  158465";"  154626";"    8704";"       0";"      88";"      88";"       0";"       0"
"1295";"A043596";"2021KW03";"    4238";"    2121";"    2117";"  463008";"  228119";"  234889";"  463008";"  422127";"  402008";"   40881";"       0";"      88";"      88";"       0";"       0"
"1296";"A043596";"2021MM10";"    1303";"     643";"     660";"  147368";"   78845";"   68523";"  147368";"  141726";"  136483";"    5642";"       0";"       0";"       0";"       0";"       0"
"1297";"A043596";"2021MM11";"     674";"     331";"     343";"   48278";"   26319";"   21959";"   48278";"   48278";"   43563";"       0";"       0";"       0";"       0";"       0";"       0"
"1298";"A043596";"2021MM12";"     541";"     285";"     256";"   40295";"   15463";"   24832";"   40295";"   40295";"   36141";"       0";"       0";"       0";"       0";"       0";"       0"
"1299";"A043596";"2021KW04";"    2518";"    1259";"    1259";"  235941";"  120627";"  115314";"  235941";"  230299";"  216187";"    5642";"       0";"       0";"       0";"       0";"       0"
"1300";"A043596";"2021JJ00";"    8307";"    4146";"    4161";"  755395";"  373032";"  382363";"  755395";"  697241";"  660274";"   58154";"       0";"      88";"      88";"       0";"       0"
"1301";"A043596";"2022MM01";"     734";"     356";"     378";"   58903";"   31498";"   27405";"   58903";"   58903";"   51443";"       0";"       0";"       0";"       0";"       0";"       0"
"1302";"A043596";"2022MM02";"     699";"     361";"     338";"   63510";"   28697";"   34813";"   63510";"   62829";"   56943";"     681";"       0";"       0";"       0";"       0";"       0"
"1303";"A043596";"2022MM03";"     989";"     485";"     504";"  101163";"   52056";"   49107";"  101163";"   96857";"   88255";"    4306";"       0";"       0";"       0";"       0";"       0"
"1304";"A043596";"2022KW01";"    2422";"    1202";"    1220";"  223576";"  112251";"  111325";"  223576";"  218589";"  196641";"    4987";"       0";"       0";"       0";"       0";"       0"
"1305";"A043596";"2022MM04";"    1437";"     721";"     716";"  139308";"   62282";"   77026";"  139308";"  135457";"  120083";"    3851";"      38";"       0";"       0";"       0";"       0"
"1306";"A043596";"2022MM05";"    1974";"     979";"     995";"  224714";"  111325";"  113389";"  224714";"  214554";"  185102";"   10160";"       0";"       0";"       0";"       0";"       0"
"1307";"A043596";"2022MM06";"    1858";"     931";"     927";"  224069";"  107372";"  116697";"  224069";"  211028";"  182094";"   13041";"       0";"       0";"       0";"       0";"       0"
"1308";"A043596";"2022KW02";"    5269";"    2631";"    2638";"  588091";"  280979";"  307112";"  588091";"  561039";"  487279";"   27052";"      38";"       0";"       0";"       0";"       0"
"1309";"A043596";"2022MM07";"    2465";"    1251";"    1214";"  312468";"  139595";"  172873";"  312468";"  286338";"  207511";"   26130";"       0";"       0";"       0";"       0";"       0"
"1310";"A043596";"2022MM08";"    2353";"    1164";"    1189";"  305371";"  164241";"  141130";"  305371";"  279646";"  199461";"   25725";"       0";"       0";"       0";"       0";"       0"
"1311";"A043596";"2022MM09";"    1927";"     967";"     960";"  226890";"  114436";"  112454";"  226890";"  212330";"  172742";"   14560";"       0";"       0";"       0";"       0";"       0"
"1312";"A043596";"2022KW03";"    6745";"    3382";"    3363";"  844729";"  418272";"  426457";"  844729";"  778314";"  579714";"   66415";"       0";"       0";"       0";"       0";"       0"
"1313";"A043596";"2022MM10";"    1914";"     950";"     964";"  232223";"  120235";"  111988";"  232223";"  218824";"  176910";"   13399";"       0";"       0";"       0";"       0";"       0"
"1314";"A043596";"2022MM11";"    1037";"     514";"     523";"  116089";"   60030";"   56059";"  116089";"   98454";"   73869";"   17635";"       0";"     328";"     328";"       0";"       0"
"1315";"A043596";"2022MM12";"     996";"     502";"     494";"  108634";"   49986";"   58648";"  108634";"   91938";"   70732";"   16696";"       0";"     116";"     116";"       0";"       0"
"1316";"A043596";"2022KW04";"    3947";"    1966";"    1981";"  456946";"  230251";"  226695";"  456946";"  409216";"  321511";"   47730";"       0";"     444";"     444";"       0";"       0"
"1317";"A043596";"2022JJ00";"   18383";"    9181";"    9202";" 2113342";" 1041753";" 1071589";" 2113342";" 1967158";" 1585145";"  146184";"      38";"     444";"     444";"       0";"       0"
"1318";"A043596";"2023MM01";"    1052";"     521";"     531";"  113614";"   57780";"   55834";"  113614";"  100578";"   83479";"   13036";"       0";"       0";"       0";"       0";"       0"
"1319";"A043596";"2023MM02";"    1108";"     557";"     551";"  123054";"   57968";"   65086";"  123054";"  110767";"   90500";"   12287";"       0";"       0";"       0";"       0";"       0"
"1320";"A043596";"2023MM03";"    1455";"     725";"     730";"  168396";"   85668";"   82728";"  168396";"  153435";"  128199";"   14961";"       0";"       0";"       0";"       0";"       0"
"1321";"A043596";"2023KW01";"    3615";"    1803";"    1812";"  405064";"  201416";"  203648";"  405064";"  364780";"  302178";"   40284";"       0";"       0";"       0";"       0";"       0"
"1322";"A043596";"2023MM04";"    1469";"     739";"     730";"  165235";"   74919";"   90316";"  165235";"  157863";"  136460";"    7372";"       0";"       0";"       0";"       0";"       0"
"1323";"A043596";"2023MM05";"    1851";"     920";"     931";"  234535";"  117182";"  117353";"  234535";"  219786";"  194077";"   14749";"       0";"       0";"       0";"       0";"       0"
"1324";"A043596";"2023MM06";"    1826";"     914";"     912";"  223911";"  109730";"  114181";"  223911";"  210856";"  186715";"   13055";"       0";"       1";"       1";"       0";"       0"
"1325";"A043596";"2023KW02";"    5146";"    2573";"    2573";"  623681";"  301831";"  321850";"  623681";"  588505";"  517252";"   35176";"       0";"       1";"       1";"       0";"       0"
"1326";"A043596";"2023MM07";"    2025";"    1011";"    1014";"  260281";"  121508";"  138773";"  260281";"  243259";"  203085";"   17022";"       0";"       0";"       0";"       0";"       0"
"1327";"A043596";"2023MM08";"    1962";"     966";"     996";"  260788";"  137880";"  122908";"  260788";"  241671";"  200739";"   19117";"       0";"       0";"       0";"       0";"       0"
"1328";"A043596";"2023MM09";"    1880";"     937";"     943";"  242114";"  122507";"  119607";"  242114";"  228932";"  196662";"   13182";"       0";"       0";"       0";"       0";"       0"
"1329";"A043596";"2023KW03";"    5867";"    2914";"    2953";"  763183";"  381895";"  381288";"  763183";"  713862";"  600486";"   49321";"       0";"       0";"       0";"       0";"       0"
"1330";"A043596";"2023MM10";"    1717";"     858";"     859";"  210975";"  111722";"   99253";"  210975";"  196811";"  164874";"   14164";"       0";"       0";"       0";"       0";"       0"
"1331";"A043596";"2023MM11";"     937";"     467";"     470";"  102953";"   53759";"   49194";"  102953";"   88697";"   68803";"   14256";"       0";"       0";"       0";"       0";"       0"
"1332";"A043596";"2023MM12";"    1078";"     544";"     534";"  118749";"   55868";"   62881";"  118749";"  102431";"   76707";"   16318";"       0";"       0";"       0";"       0";"       0"
"1333";"A043596";"2023KW04";"    3732";"    1869";"    1863";"  432677";"  221349";"  211328";"  432677";"  387939";"  310384";"   44738";"       0";"       0";"       0";"       0";"       0"
"1334";"A043596";"2023JJ00";"   18360";"    9159";"    9201";" 2224605";" 1106491";" 1118114";" 2224605";" 2055086";" 1730300";"  169519";"       0";"       1";"       1";"       0";"       0"
"1335";"A043596";"2024MM01";"    1070";"     524";"     546";"  122339";"   63009";"   59330";"  122339";"  107111";"   89166";"   15228";"       0";"       0";"       0";"       0";"       0"
"1336";"A043596";"2024MM02";"    1211";"     605";"     606";"  135742";"   66177";"   69565";"  135742";"  119944";"  100668";"   15798";"       0";"       0";"       0";"       0";"       0"
"1337";"A043596";"2024MM03";"    1262";"     631";"     631";"  145302";"   73701";"   71601";"  145302";"  133494";"  113978";"   11808";"       0";"       0";"       0";"       0";"       0"
"1338";"A043596";"2024KW01";"    3543";"    1760";"    1783";"  403383";"  202887";"  200496";"  403383";"  360549";"  303812";"   42834";"       0";"       0";"       0";"       0";"       0"
"1339";"A043596";"2024MM04";"    1497";"     742";"     755";"  172679";"   79760";"   92919";"  172679";"  159755";"  139085";"   12924";"       0";"       0";"       0";"       0";"       0"
"1340";"A043596";"2024MM05";"    1785";"     899";"     886";"  229894";"  115728";"  114166";"  229894";"  215128";"  188596";"   14766";"       0";"       0";"       0";"       0";"       0"
"1341";"A043596";"2024MM06";"    1750";"     876";"     874";"  229999";"  112806";"  117193";"  229999";"  216655";"  189135";"   13344";"       0";"       0";"       0";"       0";"       0"
"1342";"A043596";"2024KW02";"    5032";"    2517";"    2515";"  632572";"  308294";"  324278";"  632572";"  591538";"  516816";"   41034";"       0";"       0";"       0";"       0";"       0"
"1343";"A043596";"2024MM07";"    2050";"    1025";"    1025";"  258353";"  114437";"  143916";"  258353";"  230856";"  189214";"   27497";"       0";"       0";"       0";"       0";"       0"
"1344";"A043596";"2024MM08";"    1924";"     951";"     973";"  255353";"  137967";"  117386";"  255353";"  225438";"  182971";"   29915";"       0";"       0";"       0";"       0";"       0"
"1345";"A043596";"2024MM09";"    1882";"     937";"     945";"  244923";"  126649";"  118274";"  244923";"  227649";"  186859";"   17274";"       0";"       0";"       0";"       0";"       0"
"1346";"A043596";"2024KW03";"    5856";"    2913";"    2943";"  758629";"  379053";"  379576";"  758629";"  683943";"  559044";"   74686";"       0";"       0";"       0";"       0";"       0"
"1347";"A043596";"2024MM10";"    1620";"     808";"     812";"  202662";"  104843";"   97819";"  202662";"  185971";"  155905";"   16691";"       0";"       0";"       0";"       0";"       0"
"1348";"A043596";"2024MM11";"    1061";"     522";"     539";"  121085";"   65741";"   55344";"  121085";"  103318";"   80185";"   17767";"       0";"       0";"       0";"       0";"       0"
"1349";"A043596";"2024MM12";"    1070";"     541";"     529";"  120888";"   56213";"   64675";"  120888";"  101696";"   76968";"   19192";"       0";"       0";"       0";"       0";"       0"
"1350";"A043596";"2024KW04";"    3751";"    1871";"    1880";"  444635";"  226797";"  217838";"  444635";"  390985";"  313058";"   53650";"       0";"       0";"       0";"       0";"       0"
"1351";"A043596";"2024JJ00";"   18182";"    9061";"    9121";" 2239219";" 1117031";" 1122188";" 2239219";" 2027015";" 1692730";"  212204";"       0";"       0";"       0";"       0";"       0"
"1352";"A043596";"2025MM01";"    1130";"     564";"     566";"  129578";"   68190";"   61388";"  129578";"  112184";"   90758";"   17394";"       0";"       0";"       0";"       0";"       0"
"1353";"A043596";"2025MM02";"    1085";"     547";"     538";"  134517";"   65407";"   69110";"  134517";"  120604";"   99349";"   13913";"       0";"       0";"       0";"       0";"       0"
"1354";"A043596";"2025MM03";"    1253";"     620";"     633";"  149530";"   77903";"   71627";"  149530";"  142675";"  120314";"    6855";"       0";"       0";"       0";"       0";"       0"
"1355";"A043596";"2025KW01";"    3468";"    1731";"    1737";"  413625";"  211500";"  202125";"  413625";"  375463";"  310421";"   38162";"       0";"       0";"       0";"       0";"       0"
"1356";"A043596";"2025MM04";"    1514";"     762";"     752";"  194366";"   87971";"  106395";"  194366";"  175958";"  144430";"   18408";"       0";"       0";"       0";"       0";"       0"
"1357";"A043596";"2025MM05";"    1860";"     925";"     935";"  243146";"  120519";"  122627";"  243146";"  227435";"  192250";"   15711";"       0";"       0";"       0";"       0";"       0"
"1358";"A043596";"2025MM06";"    1767";"     869";"     898";"  239577";"  118834";"  120743";"  239577";"  224572";"  191082";"   15005";"       0";"       0";"       0";"       0";"       0"
"1359";"A043596";"2025KW02";"    5141";"    2556";"    2585";"  677089";"  327324";"  349765";"  677089";"  627965";"  527762";"   49124";"       0";"       0";"       0";"       0";"       0"
"1360";"A043596";"2025MM07";"    1986";"    1004";"     982";"  264323";"  117019";"  147304";"  264323";"  242080";"  201305";"   22243";"       0";"       0";"       0";"       0";"       0"
"1361";"A043596";"2025MM08";"    2061";"    1014";"    1047";"  284495";"  152975";"  131520";"  284495";"  260298";"  211043";"   24197";"       0";"       0";"       0";"       0";"       0"
"1362";"A043591";"1997JJ00";"   14511";"    7252";"    7259";"  268965";"  126461";"  142504";"  268965";"  268951";"  231157";"      14";"       0";"       0";"       0";"       0";"       0"
"1363";"A043591";"1998JJ00";"   13380";"    6615";"    6765";"  285208";"  132931";"  152277";"  285208";"  285206";"  233924";"       0";"       0";"       0";"       0";"       0";"       0"
"1364";"A043591";"1999MM01";"     991";"     488";"     503";"   16511";"    7906";"    8605";"   16511";"   16331";"   15798";"     180";"       0";"       0";"       0";"       0";"       0"
"1365";"A043591";"1999MM02";"     944";"     468";"     476";"   17315";"    8086";"    9229";"   17315";"   17315";"   16529";"       0";"       0";"       0";"       0";"       0";"       0"
"1366";"A043591";"1999MM03";"    1200";"     599";"     601";"   20933";"    9778";"   11155";"   20933";"   20933";"   20053";"       0";"       0";"       0";"       0";"       0";"       0"
"1367";"A043591";"1999KW01";"    3135";"    1555";"    1580";"   54759";"   25770";"   28989";"   54759";"   54579";"   52380";"     180";"       0";"       0";"       0";"       0";"       0"
"1368";"A043591";"1999MM04";"    1214";"     603";"     611";"   21391";"    9666";"   11725";"   21391";"   21391";"   20237";"       0";"       0";"       0";"       0";"       0";"       0"
"1369";"A043591";"1999MM05";"    1232";"     617";"     615";"   27936";"   12939";"   14997";"   27936";"   27936";"   23727";"       0";"       0";"       0";"       0";"       0";"       0"
"1370";"A043591";"1999MM06";"    1316";"     657";"     659";"   28770";"   12902";"   15868";"   28770";"   28770";"   25912";"       0";"       0";"       0";"       0";"       0";"       0"
"1371";"A043591";"1999KW02";"    3762";"    1877";"    1885";"   78097";"   35507";"   42590";"   78097";"   78097";"   69876";"       0";"       0";"       0";"       0";"       0";"       0"
"1372";"A043591";"1999MM07";"    1291";"     646";"     645";"   28296";"   12029";"   16267";"   28296";"   27501";"   20087";"     795";"       0";"       0";"       0";"       0";"       0"
"1373";"A043591";"1999MM08";"    1207";"     601";"     606";"   25783";"   13342";"   12441";"   25783";"   25782";"   17287";"       1";"       0";"       0";"       0";"       0";"       0"
"1374";"A043591";"1999MM09";"    1333";"     664";"     669";"   31621";"   14981";"   16640";"   31621";"   31621";"   26668";"       0";"       0";"       0";"       0";"       0";"       0"
"1375";"A043591";"1999KW03";"    3831";"    1911";"    1920";"   85700";"   40352";"   45348";"   85700";"   84904";"   64042";"     796";"       0";"       0";"       0";"       0";"       0"
"1376";"A043591";"1999MM10";"    1275";"     630";"     645";"   27241";"   13043";"   14198";"   27241";"   27077";"   24624";"     164";"       0";"       0";"       0";"       0";"       0"
"1377";"A043591";"1999MM11";"    1351";"     676";"     675";"   24221";"   11755";"   12466";"   24221";"   24221";"   23385";"       0";"       0";"       0";"       0";"       0";"       0"
"1378";"A043591";"1999MM12";"    1076";"     536";"     540";"   18276";"    9041";"    9235";"   18276";"   18276";"   17671";"       0";"       0";"       0";"       0";"       0";"       0"
"1379";"A043591";"1999KW04";"    3702";"    1842";"    1860";"   69738";"   33839";"   35899";"   69738";"   69574";"   65680";"     164";"       0";"       0";"       0";"       0";"       0"
"1380";"A043591";"1999JJ00";"   14430";"    7185";"    7245";"  288294";"  135468";"  152826";"  288294";"  287154";"  251978";"    1140";"       0";"       0";"       0";"       0";"       0"
"1381";"A043591";"2000MM01";"    1237";"     619";"     618";"   18799";"    9012";"    9787";"   18799";"   18799";"   18195";"       0";"       0";"       0";"       0";"       0";"       0"
"1382";"A043591";"2000MM02";"    1323";"     660";"     663";"   22568";"   10778";"   11790";"   22568";"   22568";"   21650";"       0";"       0";"       0";"       0";"       0";"       0"
"1383";"A043591";"2000MM03";"    1395";"     697";"     698";"   24254";"   11826";"   12428";"   24254";"   24254";"   23360";"       0";"       0";"       0";"       0";"       0";"       0"
"1384";"A043591";"2000KW01";"    3955";"    1976";"    1979";"   65621";"   31616";"   34005";"   65621";"   65621";"   63205";"       0";"       0";"       0";"       0";"       0";"       0"
"1385";"A043591";"2000MM04";"    1298";"     650";"     648";"   22562";"   10454";"   12108";"   22562";"   22562";"   20929";"       0";"       0";"       0";"       0";"       0";"       0"
"1386";"A043591";"2000MM05";"    1595";"     798";"     797";"   38513";"   17840";"   20673";"   38513";"   38513";"   32062";"       0";"       0";"       0";"       0";"       0";"       0"
"1387";"A043591";"2000MM06";"    1454";"     728";"     726";"   35472";"   17122";"   18350";"   35472";"   35472";"   29195";"       0";"       0";"       0";"       0";"       0";"       0"
"1388";"A043591";"2000KW02";"    4347";"    2176";"    2171";"   96547";"   45416";"   51131";"   96547";"   96547";"   82186";"       0";"       0";"       0";"       0";"       0";"       0"
"1389";"A043591";"2000MM07";"    1388";"     696";"     692";"   30039";"   13620";"   16419";"   30039";"   30039";"   20820";"       0";"       0";"       0";"       0";"       0";"       0"
"1390";"A043591";"2000MM08";"    1463";"     730";"     733";"   32147";"   16483";"   15664";"   32147";"   32147";"   22829";"       0";"       0";"       0";"       0";"       0";"       0"
"1391";"A043591";"2000MM09";"    1441";"     722";"     719";"   40756";"   19346";"   21410";"   40756";"   40756";"   31401";"       0";"       0";"       0";"       0";"       0";"       0"
"1392";"A043591";"2000KW03";"    4292";"    2148";"    2144";"  102942";"   49449";"   53493";"  102942";"  102942";"   75050";"       0";"       0";"       0";"       0";"       0";"       0"
"1393";"A043591";"2000MM10";"    1440";"     721";"     719";"   35307";"   18146";"   17161";"   35307";"   35307";"   27115";"       0";"       0";"       0";"       0";"       0";"       0"
"1394";"A043591";"2000MM11";"    1237";"     617";"     620";"   23489";"   11299";"   12190";"   23489";"   23489";"   22274";"       0";"       0";"       0";"       0";"       0";"       0"
"1395";"A043591";"2000MM12";"     903";"     449";"     454";"   16700";"    7907";"    8793";"   16700";"   16700";"   15849";"       0";"       0";"       0";"       0";"       0";"       0"
"1396";"A043591";"2000KW04";"    3580";"    1787";"    1793";"   75496";"   37352";"   38144";"   75496";"   75496";"   65238";"       0";"       0";"       0";"       0";"       0";"       0"
"1397";"A043591";"2000JJ00";"   16174";"    8087";"    8087";"  340606";"  163833";"  176773";"  340606";"  340606";"  285679";"       0";"       0";"       0";"       0";"       0";"       0"
"1398";"A043591";"2001MM01";"    1158";"     574";"     584";"   19659";"    9259";"   10400";"   19659";"   19659";"   18770";"       0";"       0";"       0";"       0";"       0";"       0"
"1399";"A043591";"2001MM02";"    1077";"     533";"     544";"   20069";"    9427";"   10642";"   20069";"   20069";"   19293";"       0";"       0";"       0";"       0";"       0";"       0"
"1400";"A043591";"2001MM03";"    1240";"     617";"     623";"   23388";"   11277";"   12111";"   23388";"   23388";"   22478";"       0";"       0";"       0";"       0";"       0";"       0"
"1401";"A043591";"2001KW01";"    3475";"    1724";"    1751";"   63116";"   29963";"   33153";"   63116";"   63116";"   60541";"       0";"       0";"       0";"       0";"       0";"       0"
"1402";"A043591";"2001MM04";"     798";"     398";"     400";"   19367";"    8771";"   10596";"   19367";"   19367";"   18628";"       0";"       0";"       0";"       0";"       0";"       0"
"1403";"A043591";"2001MM05";"     901";"     450";"     451";"   32241";"   14929";"   17312";"   32241";"   32241";"   25257";"       0";"       0";"       0";"       0";"       0";"       0"
"1404";"A043591";"2001MM06";"     917";"     456";"     461";"   27761";"   13647";"   14114";"   27761";"   27761";"   22384";"       0";"       0";"       0";"       0";"       0";"       0"
"1405";"A043591";"2001KW02";"    2616";"    1304";"    1312";"   79369";"   37347";"   42022";"   79369";"   79369";"   66269";"       0";"       0";"       0";"       0";"       0";"       0"
"1406";"A043591";"2001MM07";"     933";"     465";"     468";"   26983";"   12050";"   14933";"   26983";"   26525";"   17589";"     458";"     458";"       0";"       0";"       0";"       0"
"1407";"A043591";"2001MM08";"     996";"     499";"     497";"   26097";"   13240";"   12857";"   26097";"   26097";"   17186";"       0";"       0";"       0";"       0";"       0";"       0"
"1408";"A043591";"2001MM09";"     958";"     477";"     481";"   29447";"   13641";"   15806";"   29447";"   29447";"   22452";"       0";"       0";"       0";"       0";"       0";"       0"
"1409";"A043591";"2001KW03";"    2887";"    1441";"    1446";"   82527";"   38931";"   43596";"   82527";"   82069";"   57227";"     458";"     458";"       0";"       0";"       0";"       0"
"1410";"A043591";"2001MM10";"     993";"     496";"     497";"   25727";"   13174";"   12553";"   25727";"   25727";"   19226";"       0";"       0";"       0";"       0";"       0";"       0"
"1411";"A043591";"2001MM11";"     803";"     398";"     405";"   16638";"    7840";"    8798";"   16638";"   16638";"   16638";"       0";"       0";"       0";"       0";"       0";"       0"
"1412";"A043591";"2001MM12";"     573";"     289";"     284";"   11140";"    5534";"    5606";"   11140";"   11140";"   11140";"       0";"       0";"       0";"       0";"       0";"       0"
"1413";"A043591";"2001KW04";"    2369";"    1183";"    1186";"   53505";"   26548";"   26957";"   53505";"   53505";"   47004";"       0";"       0";"       0";"       0";"       0";"       0"
"1414";"A043591";"2001JJ00";"   11347";"    5652";"    5695";"  278517";"  132789";"  145728";"  278517";"  278059";"  231041";"     458";"     458";"       0";"       0";"       0";"       0"
"1415";"A043591";"2002MM01";"     834";"     416";"     418";"   14251";"    6800";"    7451";"   14251";"   14251";"   14251";"       0";"       0";"       0";"       0";"       0";"       0"
"1416";"A043591";"2002MM02";"     776";"     388";"     388";"   16430";"    7797";"    8633";"   16430";"   16430";"   15240";"       0";"       0";"       0";"       0";"       0";"       0"
"1417";"A043591";"2002MM03";"     837";"     418";"     419";"   19598";"    9270";"   10328";"   19598";"   19598";"   16739";"       0";"       0";"       0";"       0";"       0";"       0"
"1418";"A043591";"2002KW01";"    2447";"    1222";"    1225";"   50279";"   23867";"   26412";"   50279";"   50279";"   46230";"       0";"       0";"       0";"       0";"       0";"       0"
"1419";"A043591";"2002MM04";"     929";"     465";"     464";"   31620";"   14837";"   16783";"   31620";"   31620";"   24571";"       0";"       0";"       0";"       0";"       0";"       0"
"1420";"A043591";"2002MM05";"     958";"     476";"     482";"   40153";"   19664";"   20489";"   40153";"   40153";"   27136";"       0";"       0";"       0";"       0";"       0";"       0"
"1421";"A043591";"2002MM06";"     923";"     462";"     461";"   38311";"   19515";"   18796";"   38311";"   38311";"   28299";"       0";"       0";"       0";"       0";"       0";"       0"
"1422";"A043591";"2002KW02";"    2810";"    1403";"    1407";"  110084";"   54016";"   56068";"  110084";"  110084";"   80006";"       0";"       0";"       0";"       0";"       0";"       0"
"1423";"A043591";"2002MM07";"     957";"     477";"     480";"   36718";"   16847";"   19871";"   36718";"   36718";"   24758";"       0";"       0";"       0";"       0";"       0";"       0"
"1424";"A043591";"2002MM08";"     947";"     474";"     473";"   33272";"   17087";"   16185";"   33272";"   33272";"   24538";"       0";"       0";"       0";"       0";"       0";"       0"
"1425";"A043591";"2002MM09";"    1001";"     502";"     499";"   42045";"   20163";"   21882";"   42045";"   42045";"   30611";"       0";"       0";"       0";"       0";"       0";"       0"
"1426";"A043591";"2002KW03";"    2905";"    1453";"    1452";"  112035";"   54097";"   57938";"  112035";"  112035";"   79907";"       0";"       0";"       0";"       0";"       0";"       0"
"1427";"A043591";"2002MM10";"    1007";"     505";"     502";"   40475";"   20804";"   19671";"   40475";"   40475";"   26450";"       0";"       0";"       0";"       0";"       0";"       0"
"1428";"A043591";"2002MM11";"     885";"     442";"     443";"   28344";"   13914";"   14430";"   28344";"   28344";"   23945";"       0";"       0";"       0";"       0";"       0";"       0"
"1429";"A043591";"2002MM12";"     704";"     350";"     354";"   22156";"   11137";"   11019";"   22156";"   22156";"   20484";"       0";"       0";"       0";"       0";"       0";"       0"
"1430";"A043591";"2002KW04";"    2596";"    1297";"    1299";"   90975";"   45855";"   45120";"   90975";"   90975";"   70879";"       0";"       0";"       0";"       0";"       0";"       0"
"1431";"A043591";"2002JJ00";"   10758";"    5375";"    5383";"  363373";"  177835";"  185538";"  363373";"  363373";"  277022";"       0";"       0";"       0";"       0";"       0";"       0"
"1432";"A043591";"2003MM01";"     785";"     392";"     393";"   21306";"   10118";"   11188";"   21306";"   20973";"   19614";"     333";"       0";"       0";"       0";"       0";"       0"
"1433";"A043591";"2003MM02";"     764";"     381";"     383";"   23310";"   11391";"   11919";"   23310";"   23310";"   20991";"       0";"       0";"       0";"       0";"       0";"       0"
"1434";"A043591";"2003MM03";"     883";"     440";"     443";"   26841";"   13222";"   13619";"   26841";"   26841";"   23132";"       0";"       0";"       0";"       0";"       0";"       0"
"1435";"A043591";"2003KW01";"    2432";"    1213";"    1219";"   71457";"   34731";"   36726";"   71457";"   71124";"   63737";"     333";"       0";"       0";"       0";"       0";"       0"
"1436";"A043591";"2003MM04";"     861";"     430";"     431";"   30024";"   13751";"   16273";"   30024";"   29802";"   22212";"     222";"       0";"       0";"       0";"       0";"       0"
"1437";"A043591";"2003MM05";"     852";"     425";"     427";"   42117";"   20700";"   21417";"   42117";"   42117";"   26515";"       0";"       0";"       0";"       0";"       0";"       0"
"1438";"A043591";"2003MM06";"     852";"     428";"     424";"   40294";"   20433";"   19861";"   40294";"   40294";"   25454";"       0";"       0";"       0";"       0";"       0";"       0"
"1439";"A043591";"2003KW02";"    2565";"    1283";"    1282";"  112435";"   54884";"   57551";"  112435";"  112213";"   74181";"     222";"       0";"       0";"       0";"       0";"       0"
"1440";"A043591";"2003MM07";"     871";"     435";"     436";"   45038";"   20427";"   24611";"   45038";"   44779";"   25170";"     259";"     259";"       0";"       0";"       0";"       0"
"1441";"A043591";"2003MM08";"     810";"     407";"     403";"   43115";"   23472";"   19643";"   43115";"   43115";"   21907";"       0";"       0";"       0";"       0";"       0";"       0"
"1442";"A043591";"2003MM09";"     918";"     455";"     463";"   48495";"   23078";"   25417";"   48495";"   48495";"   29470";"       0";"       0";"       0";"       0";"       0";"       0"
"1443";"A043591";"2003KW03";"    2599";"    1297";"    1302";"  136648";"   66977";"   69671";"  136648";"  136389";"   76547";"     259";"     259";"       0";"       0";"       0";"       0"
"1444";"A043591";"2003MM10";"     891";"     451";"     440";"   47118";"   23949";"   23169";"   47118";"   47118";"   27046";"       0";"       0";"       0";"       0";"       0";"       0"
"1445";"A043591";"2003MM11";"     757";"     379";"     378";"   33605";"   16967";"   16638";"   33605";"   33605";"   25183";"       0";"       0";"       0";"       0";"       0";"       0"
"1446";"A043591";"2003MM12";"     614";"     306";"     308";"   26433";"   12924";"   13509";"   26433";"   26433";"   21852";"       0";"       0";"       0";"       0";"       0";"       0"
"1447";"A043591";"2003KW04";"    2262";"    1136";"    1126";"  107156";"   53840";"   53316";"  107156";"  107156";"   74081";"       0";"       0";"       0";"       0";"       0";"       0"
"1448";"A043591";"2003JJ00";"    9858";"    4929";"    4929";"  427696";"  210432";"  217264";"  427696";"  426882";"  288546";"     814";"     259";"       0";"       0";"       0";"       0"
"1449";"A043591";"2004MM01";"     702";"     351";"     351";"   23069";"   11549";"   11520";"   23069";"   22478";"   18845";"     591";"       0";"       0";"       0";"       0";"       0"
"1450";"A043591";"2004MM02";"     799";"     399";"     400";"   33510";"   16062";"   17448";"   33510";"   33510";"   28541";"       0";"       0";"       0";"       0";"       0";"       0"
"1451";"A043591";"2004MM03";"     945";"     472";"     473";"   42316";"   20597";"   21719";"   42316";"   42316";"   33091";"       0";"       0";"       0";"       0";"       0";"       0"
"1452";"A043591";"2004KW01";"    2446";"    1222";"    1224";"   98895";"   48208";"   50687";"   98895";"   98304";"   80477";"     591";"       0";"       0";"       0";"       0";"       0"
"1453";"A043591";"2004MM04";"     922";"     458";"     464";"   55568";"   24646";"   30922";"   55568";"   55568";"   31961";"       0";"       0";"       0";"       0";"       0";"       0"
"1454";"A043591";"2004MM05";"     989";"     494";"     495";"   75391";"   37759";"   37632";"   75391";"   75391";"   34752";"       0";"       0";"       0";"       0";"       0";"       0"
"1455";"A043591";"2004MM06";"     925";"     463";"     462";"   58287";"   30087";"   28200";"   58287";"   58287";"   31119";"       0";"       0";"       0";"       0";"       0";"       0"
"1456";"A043591";"2004KW02";"    2836";"    1415";"    1421";"  189246";"   92492";"   96754";"  189246";"  189246";"   97832";"       0";"       0";"       0";"       0";"       0";"       0"
"1457";"A043591";"2004MM07";"     909";"     453";"     456";"   68197";"   30295";"   37902";"   68197";"   68197";"   34613";"       0";"       0";"       0";"       0";"       0";"       0"
"1458";"A043591";"2004MM08";"     886";"     442";"     444";"   76327";"   40237";"   36090";"   76327";"   76327";"   33459";"       0";"       0";"       0";"       0";"       0";"       0"
"1459";"A043591";"2004MM09";"    1055";"     528";"     527";"   73712";"   36954";"   36758";"   73712";"   73712";"   43491";"       0";"       0";"       0";"       0";"       0";"       0"
"1460";"A043591";"2004KW03";"    2850";"    1423";"    1427";"  218236";"  107486";"  110750";"  218236";"  218236";"  111563";"       0";"       0";"       0";"       0";"       0";"       0"
"1461";"A043591";"2004MM10";"    1097";"     549";"     548";"   90597";"   45962";"   44635";"   90597";"   90597";"   47036";"       0";"       0";"       0";"       0";"       0";"       0"
"1462";"A043591";"2004MM11";"     946";"     472";"     474";"   62565";"   31748";"   30817";"   62565";"   62565";"   45133";"       0";"       0";"       0";"       0";"       0";"       0"
"1463";"A043591";"2004MM12";"     758";"     379";"     379";"   46930";"   22289";"   24641";"   46930";"   46807";"   39367";"     123";"       0";"     123";"     123";"       0";"       0"
"1464";"A043591";"2004KW04";"    2801";"    1400";"    1401";"  200092";"   99999";"  100093";"  200092";"  199969";"  131536";"     123";"       0";"     123";"     123";"       0";"       0"
"1465";"A043591";"2004JJ00";"   10933";"    5460";"    5473";"  706469";"  348185";"  358284";"  706469";"  705755";"  421408";"     714";"       0";"     123";"     123";"       0";"       0"
"1466";"A043591";"2005MM01";"     605";"     302";"     303";"   42455";"   21365";"   21090";"   42455";"   41744";"   34628";"     711";"       0";"       0";"       0";"       0";"       0"
"1467";"A043591";"2005MM02";"     596";"     297";"     299";"   44363";"   21429";"   22934";"   44363";"   44363";"   36984";"       0";"       0";"       0";"       0";"       0";"       0"
"1468";"A043591";"2005MM03";"     765";"     381";"     384";"   60974";"   29079";"   31895";"   60974";"   60974";"   48049";"       0";"       0";"       0";"       0";"       0";"       0"
"1469";"A043591";"2005KW01";"    1966";"     980";"     986";"  147792";"   71873";"   75919";"  147792";"  147081";"  119661";"     711";"       0";"       0";"       0";"       0";"       0"
"1470";"A043591";"2005MM04";"     863";"     427";"     436";"   75542";"   34965";"   40577";"   75542";"   75542";"   55934";"       0";"       0";"       0";"       0";"       0";"       0"
"1471";"A043591";"2005MM05";"    1039";"     518";"     521";"  104897";"   51268";"   53629";"  104897";"  104897";"   66126";"       0";"       0";"       0";"       0";"       0";"       0"
"1472";"A043591";"2005MM06";"    1103";"     554";"     549";"   97270";"   47544";"   49726";"   97270";"   97270";"   66870";"       0";"       0";"       0";"       0";"       0";"       0"
"1473";"A043591";"2005KW02";"    3005";"    1499";"    1506";"  277709";"  133777";"  143932";"  277709";"  277709";"  188930";"       0";"       0";"       0";"       0";"       0";"       0"
"1474";"A043591";"2005MM07";"    1006";"     503";"     503";"  105929";"   46317";"   59612";"  105929";"  105929";"   65248";"       0";"       0";"       0";"       0";"       0";"       0"
"1475";"A043591";"2005MM08";"    1057";"     528";"     529";"  107710";"   57232";"   50478";"  107710";"  107605";"   68006";"     105";"       0";"     105";"     105";"       0";"       0"
"1476";"A043591";"2005MM09";"    1127";"     564";"     563";"   98111";"   47477";"   50634";"   98111";"   98111";"   68419";"       0";"       0";"       0";"       0";"       0";"       0"
"1477";"A043591";"2005KW03";"    3190";"    1595";"    1595";"  311750";"  151026";"  160724";"  311750";"  311645";"  201673";"     105";"       0";"     105";"     105";"       0";"       0"
"1478";"A043591";"2005MM10";"    1060";"     535";"     525";"   99264";"   50825";"   48439";"   99264";"   99264";"   64344";"       0";"       0";"       0";"       0";"       0";"       0"
"1479";"A043591";"2005MM11";"     909";"     453";"     456";"   72658";"   36565";"   36093";"   72658";"   72658";"   62344";"       0";"       0";"       0";"       0";"       0";"       0"
"1480";"A043591";"2005MM12";"     766";"     381";"     385";"   63661";"   30800";"   32861";"   63661";"   63661";"   57543";"       0";"       0";"       0";"       0";"       0";"       0"
"1481";"A043591";"2005KW04";"    2735";"    1369";"    1366";"  235583";"  118190";"  117393";"  235583";"  235583";"  184231";"       0";"       0";"       0";"       0";"       0";"       0"
"1482";"A043591";"2005JJ00";"   10896";"    5443";"    5453";"  972834";"  474866";"  497968";"  972834";"  972018";"  694495";"     816";"       0";"     105";"     105";"       0";"       0"
"1483";"A043591";"2006MM01";"     782";"     391";"     391";"   61431";"   31112";"   30319";"   61431";"   60853";"   53825";"     578";"       0";"       0";"       0";"       0";"       0"
"1484";"A043591";"2006MM02";"     710";"     355";"     355";"   57789";"   27641";"   30148";"   57789";"   57693";"   53857";"       0";"       0";"       0";"       0";"       0";"       0"
"1485";"A043591";"2006MM03";"     839";"     417";"     422";"   70541";"   34565";"   35976";"   70541";"   70541";"   64151";"       0";"       0";"       0";"       0";"       0";"       0"
"1486";"A043591";"2006KW01";"    2331";"    1163";"    1168";"  189761";"   93318";"   96443";"  189761";"  189087";"  171833";"     578";"       0";"       0";"       0";"       0";"       0"
"1487";"A043591";"2006MM04";"     710";"     352";"     358";"   69597";"   32864";"   36733";"   69597";"   69597";"   68870";"       0";"       0";"       0";"       0";"       0";"       0"
"1488";"A043591";"2006MM05";"    1185";"     587";"     598";"  137011";"   67427";"   69584";"  137011";"  136965";"  107938";"      46";"       0";"      46";"      46";"       0";"       0"
"1489";"A043591";"2006MM06";"    1048";"     506";"     542";"  109559";"   53962";"   55597";"  109559";"  109559";"   88205";"       0";"       0";"       0";"       0";"       0";"       0"
"1490";"A043591";"2006KW02";"    2943";"    1445";"    1498";"  316167";"  154253";"  161914";"  316167";"  316121";"  265013";"      46";"       0";"      46";"      46";"       0";"       0"
"1491";"A043591";"2006MM07";"    1014";"     485";"     529";"  122003";"   54514";"   67489";"  122003";"  122003";"   86368";"       0";"       0";"       0";"       0";"       0";"       0"
"1492";"A043591";"2006MM08";"    1060";"     509";"     551";"  118632";"   62990";"   55642";"  118632";"  118632";"   86399";"       0";"       0";"       0";"       0";"       0";"       0"
"1493";"A043591";"2006MM09";"    1078";"     515";"     563";"  116246";"   56124";"   60122";"  116246";"  116150";"   90469";"      96";"      96";"       0";"       0";"       0";"       0"
"1494";"A043591";"2006KW03";"    3152";"    1509";"    1643";"  356881";"  173628";"  183253";"  356881";"  356785";"  263236";"      96";"      96";"       0";"       0";"       0";"       0"
"1495";"A043591";"2006MM10";"    1072";"     522";"     550";"  116287";"   59296";"   56991";"  116287";"  116287";"   89012";"       0";"       0";"       0";"       0";"       0";"       0"
"1496";"A043591";"2006MM11";"    1024";"     489";"     535";"   98664";"   50562";"   48102";"   98664";"   98664";"   94131";"       0";"       0";"       0";"       0";"       0";"       0"
"1497";"A043591";"2006MM12";"     876";"     424";"     452";"   92761";"   44203";"   48558";"   92761";"   92761";"   91003";"       0";"       0";"       0";"       0";"       0";"       0"
"1498";"A043591";"2006KW04";"    2972";"    1435";"    1537";"  307712";"  154061";"  153651";"  307712";"  307712";"  274146";"       0";"       0";"       0";"       0";"       0";"       0"
"1499";"A043591";"2006JJ00";"   11398";"    5552";"    5846";" 1170521";"  575260";"  595261";" 1170521";" 1169705";"  974228";"     720";"      96";"      46";"      46";"       0";"       0"
"1500";"A043591";"2007MM01";"     919";"     441";"     478";"   88399";"   44875";"   43524";"   88399";"   87736";"   86289";"     663";"       0";"       0";"       0";"       0";"       0"
"1501";"A043591";"2007MM02";"     861";"     409";"     452";"   86236";"   41241";"   44995";"   86236";"   86236";"   85739";"       0";"       0";"       0";"       0";"       0";"       0"
"1502";"A043591";"2007MM03";"    1056";"     505";"     551";"  108487";"   52928";"   55559";"  108487";"  108487";"  106072";"       0";"       0";"       0";"       0";"       0";"       0"
"1503";"A043591";"2007KW01";"    2836";"    1355";"    1481";"  283122";"  139044";"  144078";"  283122";"  282459";"  278100";"     663";"       0";"       0";"       0";"       0";"       0"
"1504";"A043591";"2007MM04";"    1020";"     491";"     529";"  119980";"   56346";"   63634";"  119980";"  119980";"  109566";"       0";"       0";"       0";"       0";"       0";"       0"
"1505";"A043591";"2007MM05";"     957";"     457";"     500";"  128921";"   63785";"   65136";"  128921";"  128921";"  128436";"       0";"       0";"       0";"       0";"       0";"       0"
"1506";"A043591";"2007MM06";"    1245";"     602";"     643";"  147961";"   72893";"   75068";"  147961";"  147961";"  131238";"       0";"       0";"       0";"       0";"       0";"       0"
"1507";"A043591";"2007KW02";"    3222";"    1550";"    1672";"  396862";"  193024";"  203838";"  396862";"  396862";"  369240";"       0";"       0";"       0";"       0";"       0";"       0"
"1508";"A043591";"2007MM07";"     781";"     368";"     413";"  107850";"   50963";"   56887";"  107850";"  107850";"  105519";"       0";"       0";"       0";"       0";"       0";"       0"
"1509";"A043591";"2007MM08";"    1200";"     578";"     622";"  160141";"   84818";"   75323";"  160141";"  160141";"  138772";"       0";"       0";"       0";"       0";"       0";"       0"
"1510";"A043591";"2007MM09";"    1227";"     594";"     633";"  148987";"   72523";"   76464";"  148987";"  148987";"  133331";"       0";"       0";"       0";"       0";"       0";"       0"
"1511";"A043591";"2007KW03";"    3208";"    1540";"    1668";"  416978";"  208304";"  208674";"  416978";"  416978";"  377622";"       0";"       0";"       0";"       0";"       0";"       0"
"1512";"A043591";"2007MM10";"    1337";"     649";"     688";"  149522";"   77212";"   72310";"  149522";"  149522";"  131681";"       0";"       0";"       0";"       0";"       0";"       0"
"1513";"A043591";"2007MM11";"     721";"     350";"     371";"   88589";"   43887";"   44702";"   88589";"   88589";"   88589";"       0";"       0";"       0";"       0";"       0";"       0"
"1514";"A043591";"2007MM12";"    1066";"     518";"     548";"  107503";"   51888";"   55615";"  107503";"  106871";"  105875";"     632";"       0";"       0";"       0";"       0";"       0"
"1515";"A043591";"2007KW04";"    3124";"    1517";"    1607";"  345614";"  172987";"  172627";"  345614";"  344982";"  326145";"     632";"       0";"       0";"       0";"       0";"       0"
"1516";"A043591";"2007JJ00";"   12390";"    5962";"    6428";" 1442576";"  713359";"  729217";" 1442576";" 1441281";" 1351107";"    1295";"       0";"       0";"       0";"       0";"       0"
"1517";"A043591";"2008MM01";"    1096";"     535";"     561";"  102144";"   51183";"   50961";"  102144";"  101064";"  100249";"    1080";"       0";"       0";"       0";"       0";"       0"
"1518";"A043591";"2008MM02";"    1102";"     542";"     560";"  107895";"   52606";"   55289";"  107895";"  106573";"  105729";"    1321";"       0";"       0";"       0";"       0";"       0"
"1519";"A043591";"2008MM03";"    1187";"     583";"     604";"  126272";"   62144";"   64128";"  126272";"  125041";"  122626";"    1231";"       0";"       0";"       0";"       0";"       0"
"1520";"A043591";"2008KW01";"    3385";"    1660";"    1725";"  336311";"  165933";"  170378";"  336311";"  332678";"  328604";"    3632";"       0";"       0";"       0";"       0";"       0"
"1521";"A043591";"2008MM04";"    1228";"     610";"     618";"  130204";"   59862";"   70342";"  130204";"  130204";"  123315";"       0";"       0";"       0";"       0";"       0";"       0"
"1522";"A043591";"2008MM05";"    1350";"     675";"     675";"  168148";"   83522";"   84626";"  168148";"  168026";"  149698";"     122";"       0";"     122";"     122";"       0";"       0"
"1523";"A043591";"2008MM06";"    1370";"     687";"     683";"  159518";"   78509";"   81009";"  159518";"  159518";"  142129";"       0";"       0";"       0";"       0";"       0";"       0"
"1524";"A043591";"2008KW02";"    3948";"    1972";"    1976";"  457870";"  221893";"  235977";"  457870";"  457748";"  415142";"     122";"       0";"     122";"     122";"       0";"       0"
"1525";"A043591";"2008MM07";"    1380";"     689";"     691";"  176308";"   81335";"   94973";"  176308";"  176308";"  152171";"       0";"       0";"       0";"       0";"       0";"       0"
"1526";"A043591";"2008MM08";"    1259";"     627";"     632";"  169222";"   89540";"   79682";"  169222";"  169222";"  149869";"       0";"       0";"       0";"       0";"       0";"       0"
"1527";"A043591";"2008MM09";"    1352";"     675";"     677";"  158891";"   76427";"   82464";"  158891";"  158465";"  141285";"     426";"       0";"     426";"     426";"       0";"       0"
"1528";"A043591";"2008KW03";"    3991";"    1991";"    2000";"  504421";"  247302";"  257119";"  504421";"  503995";"  443325";"     426";"       0";"     426";"     426";"       0";"       0"
"1529";"A043591";"2008MM10";"    1367";"     686";"     681";"  162130";"   83853";"   78277";"  162130";"  161720";"  144848";"     410";"       0";"     410";"     410";"       0";"       0"
"1530";"A043591";"2008MM11";"     929";"     465";"     464";"  106323";"   53496";"   52827";"  106323";"  106012";"  104621";"     311";"       0";"     311";"     311";"       0";"       0"
"1531";"A043591";"2008MM12";"     871";"     433";"     438";"   99362";"   47347";"   52015";"   99362";"   99362";"   99362";"       0";"       0";"       0";"       0";"       0";"       0"
"1532";"A043591";"2008KW04";"    3167";"    1584";"    1583";"  367815";"  184696";"  183119";"  367815";"  367094";"  348831";"     721";"       0";"     721";"     721";"       0";"       0"
"1533";"A043591";"2008JJ00";"   14491";"    7207";"    7284";" 1666417";"  819824";"  846593";" 1666417";" 1661515";" 1535902";"    4901";"       0";"    1269";"    1269";"       0";"       0"
"1534";"A043591";"2009MM01";"     855";"     428";"     427";"   90493";"   44505";"   45988";"   90493";"   90493";"   90377";"       0";"       0";"       0";"       0";"       0";"       0"
"1535";"A043591";"2009MM02";"     828";"     413";"     415";"   99373";"   47727";"   51646";"   99373";"   99373";"   98840";"       0";"       0";"       0";"       0";"       0";"       0"
"1536";"A043591";"2009MM03";"     936";"     468";"     468";"  112728";"   55991";"   56737";"  112728";"  112728";"  111427";"       0";"       0";"       0";"       0";"       0";"       0"
"1537";"A043591";"2009KW01";"    2619";"    1309";"    1310";"  302594";"  148223";"  154371";"  302594";"  302594";"  300644";"       0";"       0";"       0";"       0";"       0";"       0"
"1538";"A043591";"2009MM04";"    1006";"     498";"     508";"  129572";"   59593";"   69979";"  129572";"  129572";"  121344";"       0";"       0";"       0";"       0";"       0";"       0"
"1539";"A043591";"2009MM05";"    1171";"     587";"     584";"  156447";"   77668";"   78779";"  156447";"  156447";"  138028";"       0";"       0";"       0";"       0";"       0";"       0"
"1540";"A043591";"2009MM06";"    1177";"     589";"     588";"  155013";"   76607";"   78406";"  155013";"  154770";"  140282";"     243";"       0";"     243";"     243";"       0";"       0"
"1541";"A043591";"2009KW02";"    3354";"    1674";"    1680";"  441032";"  213868";"  227164";"  441032";"  440789";"  399654";"     243";"       0";"     243";"     243";"       0";"       0"
"1542";"A043591";"2009MM07";"    1301";"     651";"     650";"  180926";"   82130";"   98796";"  180926";"  180319";"  161898";"     607";"     189";"     418";"     418";"       0";"       0"
"1543";"A043591";"2009MM08";"    1303";"     652";"     651";"  191063";"   99087";"   91976";"  191063";"  190994";"  168379";"      69";"       0";"      69";"      69";"       0";"       0"
"1544";"A043591";"2009MM09";"    1333";"     667";"     666";"  179745";"   89217";"   90528";"  179745";"  179693";"  160579";"      52";"       0";"       0";"       0";"       0";"       0"
"1545";"A043591";"2009KW03";"    3937";"    1970";"    1967";"  551734";"  270434";"  281300";"  551734";"  551006";"  490856";"     728";"     189";"     487";"     487";"       0";"       0"
"1546";"A043591";"2009MM10";"    1301";"     654";"     647";"  175596";"   89713";"   85883";"  175596";"  175596";"  154631";"       0";"       0";"       0";"       0";"       0";"       0"
"1547";"A043591";"2009MM11";"    1136";"     569";"     567";"  139322";"   71533";"   67789";"  139322";"  139322";"  135302";"       0";"       0";"       0";"       0";"       0";"       0"
"1548";"A043591";"2009MM12";"    1085";"     541";"     544";"  128775";"   62024";"   66751";"  128775";"  128775";"  126188";"       0";"       0";"       0";"       0";"       0";"       0"
"1549";"A043591";"2009KW04";"    3522";"    1764";"    1758";"  443693";"  223270";"  220423";"  443693";"  443693";"  416121";"       0";"       0";"       0";"       0";"       0";"       0"
"1550";"A043591";"2009JJ00";"   13432";"    6717";"    6715";" 1739053";"  855795";"  883258";" 1739053";" 1738082";" 1607275";"     971";"     189";"     730";"     730";"       0";"       0"
"1551";"A043591";"2010MM01";"    1077";"     541";"     536";"  111396";"   55915";"   55481";"  111396";"  111231";"  109174";"     165";"       0";"       0";"       0";"       0";"       0"
"1552";"A043591";"2010MM02";"    1064";"     531";"     533";"  122333";"   59362";"   62971";"  122333";"  122333";"  120059";"       0";"       0";"       0";"       0";"       0";"       0"
"1553";"A043591";"2010MM03";"    1180";"     589";"     591";"  146181";"   72779";"   73402";"  146181";"  146181";"  142760";"       0";"       0";"       0";"       0";"       0";"       0"
"1554";"A043591";"2010KW01";"    3321";"    1661";"    1660";"  379910";"  188056";"  191854";"  379910";"  379745";"  371993";"     165";"       0";"       0";"       0";"       0";"       0"
"1555";"A043591";"2010MM04";"    1090";"     543";"     547";"  138095";"   63317";"   74778";"  138095";"  138095";"  128347";"       0";"       0";"       0";"       0";"       0";"       0"
"1556";"A043591";"2010MM05";"    1558";"     782";"     776";"  215232";"  104568";"  110664";"  215232";"  215232";"  189129";"       0";"       0";"       0";"       0";"       0";"       0"
"1557";"A043591";"2010MM06";"    1493";"     746";"     747";"  203811";"  100731";"  103080";"  203811";"  203811";"  185719";"       0";"       0";"       0";"       0";"       0";"       0"
"1558";"A043591";"2010KW02";"    4141";"    2071";"    2070";"  557138";"  268616";"  288522";"  557138";"  557138";"  503195";"       0";"       0";"       0";"       0";"       0";"       0"
"1559";"A043591";"2010MM07";"    1629";"     813";"     816";"  234520";"  106546";"  127974";"  234520";"  234520";"  210452";"       0";"       0";"       0";"       0";"       0";"       0"
"1560";"A043591";"2010MM08";"    1721";"     861";"     860";"  258180";"  134554";"  123626";"  258180";"  258180";"  229595";"       0";"       0";"       0";"       0";"       0";"       0"
"1561";"A043591";"2010MM09";"    1602";"     801";"     801";"  227950";"  113923";"  114027";"  227950";"  227905";"  207333";"       0";"       0";"       0";"       0";"       0";"       0"
"1562";"A043591";"2010KW03";"    4952";"    2475";"    2477";"  720650";"  355023";"  365627";"  720650";"  720605";"  647380";"       0";"       0";"       0";"       0";"       0";"       0"
"1563";"A043591";"2010MM10";"    1557";"     780";"     777";"  225069";"  113795";"  111274";"  225069";"  225069";"  198851";"       0";"       0";"       0";"       0";"       0";"       0"
"1564";"A043591";"2010MM11";"    1140";"     569";"     571";"  152368";"   77796";"   74572";"  152368";"  152368";"  147708";"       0";"       0";"       0";"       0";"       0";"       0"
"1565";"A043591";"2010MM12";"    1133";"     568";"     565";"  147648";"   70239";"   77409";"  147648";"  147408";"  144655";"     240";"     240";"       0";"       0";"       0";"       0"
"1566";"A043591";"2010KW04";"    3830";"    1917";"    1913";"  525085";"  261830";"  263255";"  525085";"  524845";"  491214";"     240";"     240";"       0";"       0";"       0";"       0"
"1567";"A043591";"2010JJ00";"   16244";"    8124";"    8120";" 2182783";" 1073525";" 1109258";" 2182783";" 2182333";" 2013782";"     405";"     240";"       0";"       0";"       0";"       0"
"1568";"A043591";"2011MM01";"    1232";"     616";"     616";"  142884";"   71925";"   70959";"  142884";"  142884";"  140193";"       0";"       0";"       0";"       0";"       0";"       0"
"1569";"A043591";"2011MM02";"    1079";"     539";"     540";"  133658";"   64665";"   68993";"  133658";"  133658";"  131505";"       0";"       0";"       0";"       0";"       0";"       0"
"1570";"A043591";"2011MM03";"    1258";"     628";"     630";"  167750";"   82993";"   84757";"  167750";"  167750";"  163387";"       0";"       0";"       0";"       0";"       0";"       0"
"1571";"A043591";"2011KW01";"    3569";"    1783";"    1786";"  444292";"  219583";"  224709";"  444292";"  444292";"  435085";"       0";"       0";"       0";"       0";"       0";"       0"
"1572";"A043591";"2011MM04";"    1642";"     819";"     823";"  228844";"  106805";"  122039";"  228844";"  228844";"  210496";"       0";"       0";"       0";"       0";"       0";"       0"
"1573";"A043591";"2011MM05";"    2037";"    1022";"    1015";"  275801";"  137585";"  138216";"  275801";"  275801";"  242133";"       0";"       0";"       0";"       0";"       0";"       0"
"1574";"A043591";"2011MM06";"    1919";"     960";"     959";"  257143";"  128878";"  128265";"  257143";"  256933";"  234519";"     183";"       0";"       0";"       0";"       0";"       0"
"1575";"A043591";"2011KW02";"    5598";"    2801";"    2797";"  761788";"  373268";"  388520";"  761788";"  761578";"  687148";"     183";"       0";"       0";"       0";"       0";"       0"
"1576";"A043591";"2011MM07";"    2022";"    1012";"    1010";"  292858";"  133189";"  159669";"  292858";"  291720";"  258886";"    1138";"       0";"       0";"       0";"       0";"       0"
"1577";"A043591";"2011MM08";"    2037";"    1019";"    1018";"  296529";"  157254";"  139275";"  296529";"  296010";"  262386";"     519";"       0";"       0";"       0";"       0";"       0"
"1578";"A043591";"2011MM09";"    1938";"     971";"     967";"  271311";"  136022";"  135289";"  271311";"  271311";"  243517";"       0";"       0";"       0";"       0";"       0";"       0"
"1579";"A043591";"2011KW03";"    5997";"    3002";"    2995";"  860698";"  426465";"  434233";"  860698";"  859041";"  764789";"    1657";"       0";"       0";"       0";"       0";"       0"
"1580";"A043591";"2011MM10";"    1892";"     946";"     946";"  264018";"  135084";"  128934";"  264018";"  263461";"  233855";"     557";"       0";"     192";"     192";"       0";"       0"
"1581";"A043591";"2011MM11";"    1260";"     631";"     629";"  162061";"   84722";"   77339";"  162061";"  159768";"  153548";"    2293";"       0";"       0";"       0";"       0";"       0"
"1582";"A043591";"2011MM12";"    1364";"     682";"     682";"  171221";"   80956";"   90265";"  171221";"  168667";"  165272";"    2554";"       0";"       0";"       0";"       0";"       0"
"1583";"A043591";"2011KW04";"    4516";"    2259";"    2257";"  597300";"  300762";"  296538";"  597300";"  591896";"  552675";"    5404";"       0";"     192";"     192";"       0";"       0"
"1584";"A043591";"2011JJ00";"   19680";"    9845";"    9835";" 2664078";" 1320078";" 1344000";" 2664078";" 2656807";" 2439697";"    7244";"       0";"     192";"     192";"       0";"       0"
"1585";"A043591";"2012MM01";"    1480";"     739";"     741";"  168756";"   87815";"   80941";"  168756";"  165981";"  161957";"    2775";"       0";"       0";"       0";"       0";"       0"
"1586";"A043591";"2012MM02";"    1396";"     697";"     699";"  169767";"   81908";"   87859";"  169767";"  167127";"  161993";"    2640";"       0";"       0";"       0";"       0";"       0"
"1587";"A043591";"2012MM03";"    1623";"     809";"     814";"  203430";"  101753";"  101677";"  203430";"  200295";"  193859";"    3135";"       0";"       0";"       0";"       0";"       0"
"1588";"A043591";"2012KW01";"    4499";"    2245";"    2254";"  541953";"  271476";"  270477";"  541953";"  533403";"  517809";"    8550";"       0";"       0";"       0";"       0";"       0"
"1589";"A043591";"2012MM04";"    1925";"     961";"     964";"  259863";"  123273";"  136590";"  259863";"  256629";"  238107";"    3234";"       0";"       0";"       0";"       0";"       0"
"1590";"A043591";"2012MM05";"    2239";"    1118";"    1121";"  301954";"  150208";"  151746";"  301954";"  298751";"  264420";"    3203";"       0";"       0";"       0";"       0";"       0"
"1591";"A043591";"2012MM06";"    2153";"    1076";"    1077";"  288737";"  142280";"  146457";"  288737";"  286079";"  257313";"    2658";"       0";"       0";"       0";"       0";"       0"
"1592";"A043591";"2012KW02";"    6317";"    3155";"    3162";"  850554";"  415761";"  434793";"  850554";"  841459";"  759840";"    9095";"       0";"       0";"       0";"       0";"       0"
"1593";"A043591";"2012MM07";"    2302";"    1151";"    1151";"  334961";"  155414";"  179547";"  334961";"  331895";"  294154";"    3066";"       0";"       0";"       0";"       0";"       0"
"1594";"A043591";"2012MM08";"    2249";"    1125";"    1124";"  325367";"  172025";"  153342";"  325367";"  322338";"  288168";"    3029";"       0";"       0";"       0";"       0";"       0"
"1595";"A043591";"2012MM09";"    2141";"    1069";"    1072";"  292550";"  146998";"  145552";"  292550";"  289452";"  258757";"    3098";"       0";"       0";"       0";"       0";"       0"
"1596";"A043591";"2012KW03";"    6692";"    3345";"    3347";"  952878";"  474437";"  478441";"  952878";"  943685";"  841079";"    9193";"       0";"       0";"       0";"       0";"       0"
"1597";"A043591";"2012MM10";"    2119";"    1061";"    1058";"  288342";"  148839";"  139503";"  288342";"  285523";"  251754";"    2819";"       0";"       0";"       0";"       0";"       0"
"1598";"A043591";"2012MM11";"    1413";"     706";"     707";"  184715";"   96071";"   88644";"  184715";"  182136";"  171313";"    2579";"       0";"       0";"       0";"       0";"       0"
"1599";"A043591";"2012MM12";"    1410";"     703";"     707";"  186496";"   87621";"   98875";"  186496";"  184046";"  177056";"    2450";"       0";"       0";"       0";"       0";"       0"
"1600";"A043591";"2012KW04";"    4942";"    2470";"    2472";"  659553";"  332531";"  327022";"  659553";"  651705";"  600123";"    7848";"       0";"       0";"       0";"       0";"       0"
"1601";"A043591";"2012JJ00";"   22450";"   11215";"   11235";" 3004938";" 1494205";" 1510733";" 3004938";" 2970252";" 2718851";"   34686";"       0";"       0";"       0";"       0";"       0"
"1602";"A043591";"2013MM01";"    1596";"     797";"     799";"  177554";"   93064";"   84490";"  177554";"  174984";"  166171";"    2570";"       0";"       0";"       0";"       0";"       0"
"1603";"A043591";"2013MM02";"    1477";"     739";"     738";"  185145";"   90848";"   94297";"  185145";"  182398";"  173520";"    2747";"       0";"       0";"       0";"       0";"       0"
"1604";"A043591";"2013MM03";"    1840";"     919";"     921";"  234218";"  115188";"  119030";"  234218";"  230808";"  220155";"    3410";"       0";"       0";"       0";"       0";"       0"
"1605";"A043591";"2013KW01";"    4913";"    2455";"    2458";"  596917";"  299100";"  297817";"  596917";"  588190";"  559846";"    8727";"       0";"       0";"       0";"       0";"       0"
"1606";"A043591";"2013MM04";"    2074";"    1036";"    1038";"  286436";"  137488";"  148948";"  286436";"  278862";"  256529";"    7574";"       0";"       0";"       0";"       0";"       0"
"1607";"A043591";"2013MM05";"    2417";"    1208";"    1209";"  342948";"  169895";"  173053";"  342948";"  334689";"  298889";"    8259";"       0";"       0";"       0";"       0";"       0"
"1608";"A043591";"2013MM06";"    2324";"    1160";"    1164";"  329938";"  162136";"  167802";"  329938";"  322829";"  289471";"    7109";"       0";"       0";"       0";"       0";"       0"
"1609";"A043591";"2013KW02";"    6815";"    3404";"    3411";"  959322";"  469519";"  489803";"  959322";"  936380";"  844889";"   22942";"       0";"       0";"       0";"       0";"       0"
"1610";"A043591";"2013MM07";"    2471";"    1235";"    1236";"  372682";"  174175";"  198507";"  372682";"  364642";"  324147";"    8040";"       0";"       0";"       0";"       0";"       0"
"1611";"A043591";"2013MM08";"    2439";"    1219";"    1220";"  370304";"  194049";"  176255";"  370304";"  361368";"  324370";"    8936";"       0";"       0";"       0";"       0";"       0"
"1612";"A043591";"2013MM09";"    2391";"    1194";"    1197";"  351005";"  177270";"  173735";"  351005";"  342871";"  308247";"    8134";"       0";"       0";"       0";"       0";"       0"
"1613";"A043591";"2013KW03";"    7301";"    3648";"    3653";" 1093991";"  545494";"  548497";" 1093991";" 1068881";"  956764";"   25110";"       0";"       0";"       0";"       0";"       0"
"1614";"A043591";"2013MM10";"    2312";"    1155";"    1157";"  338783";"  174472";"  164311";"  338783";"  329788";"  294286";"    8995";"       0";"       0";"       0";"       0";"       0"
"1615";"A043591";"2013MM11";"    1650";"     823";"     827";"  223320";"  115741";"  107579";"  223320";"  217027";"  203166";"    6293";"       0";"       0";"       0";"       0";"       0"
"1616";"A043591";"2013MM12";"    1602";"     801";"     801";"  213152";"  100806";"  112346";"  213152";"  206433";"  194931";"    6719";"       0";"       0";"       0";"       0";"       0"
"1617";"A043591";"2013KW04";"    5564";"    2779";"    2785";"  775255";"  391019";"  384236";"  775255";"  753248";"  692383";"   22007";"       0";"       0";"       0";"       0";"       0"
"1618";"A043591";"2013JJ00";"   24593";"   12286";"   12307";" 3425485";" 1705132";" 1720353";" 3425485";" 3346699";" 3053882";"   78786";"       0";"       0";"       0";"       0";"       0"
"1619";"A043591";"2014MM01";"    1787";"     895";"     892";"  210766";"  109327";"  101439";"  210766";"  204498";"  192798";"    6268";"       0";"       0";"       0";"       0";"       0"
"1620";"A043591";"2014MM02";"    1628";"     814";"     814";"  212377";"  103209";"  109168";"  212377";"  205962";"  195858";"    6415";"       0";"       0";"       0";"       0";"       0"
"1621";"A043591";"2014MM03";"    1898";"     949";"     949";"  259430";"  131300";"  128130";"  259430";"  252568";"  237999";"    6862";"       0";"       0";"       0";"       0";"       0"
"1622";"A043591";"2014KW01";"    5313";"    2658";"    2655";"  682573";"  343836";"  338737";"  682573";"  663028";"  626655";"   19545";"       0";"       0";"       0";"       0";"       0"
"1623";"A043591";"2014MM04";"    2338";"    1167";"    1171";"  345746";"  161868";"  183878";"  345746";"  339890";"  310347";"    5856";"       0";"       0";"       0";"       0";"       0"
"1624";"A043591";"2014MM05";"    2743";"    1370";"    1373";"  412805";"  206081";"  206724";"  412805";"  406415";"  365535";"    6390";"       0";"       0";"       0";"       0";"       0"
"1625";"A043591";"2014MM06";"    2635";"    1318";"    1317";"  395700";"  200290";"  195410";"  395700";"  390107";"  356367";"    5593";"       0";"       0";"       0";"       0";"       0"
"1626";"A043591";"2014KW02";"    7716";"    3855";"    3861";" 1154251";"  568239";"  586012";" 1154251";" 1136412";" 1032249";"   17839";"       0";"       0";"       0";"       0";"       0"
"1627";"A043591";"2014MM07";"    2682";"    1339";"    1343";"  413599";"  191198";"  222401";"  413599";"  408873";"  372473";"    4726";"       0";"       0";"       0";"       0";"       0"
"1628";"A043591";"2014MM08";"    2720";"    1359";"    1361";"  434612";"  227796";"  206816";"  434612";"  427071";"  386587";"    7541";"       0";"       0";"       0";"       0";"       0"
"1629";"A043591";"2014MM09";"    2618";"    1308";"    1310";"  392699";"  198870";"  193829";"  392699";"  386444";"  351351";"    6255";"       0";"       0";"       0";"       0";"       0"
"1630";"A043591";"2014KW03";"    8020";"    4006";"    4014";" 1240910";"  617864";"  623046";" 1240910";" 1222388";" 1110411";"   18522";"       0";"       0";"       0";"       0";"       0"
"1631";"A043591";"2014MM10";"    2535";"    1267";"    1268";"  382483";"  196824";"  185659";"  382483";"  375488";"  340776";"    6995";"       0";"       0";"       0";"       0";"       0"
"1632";"A043591";"2014MM11";"    1702";"     852";"     850";"  249652";"  129954";"  119698";"  249652";"  238022";"  225610";"   11630";"       0";"       0";"       0";"       0";"       0"
"1633";"A043591";"2014MM12";"    1737";"     868";"     869";"  246495";"  117617";"  128878";"  246495";"  237270";"  227262";"    9225";"       0";"       0";"       0";"       0";"       0"
"1634";"A043591";"2014KW04";"    5974";"    2987";"    2987";"  878630";"  444395";"  434235";"  878630";"  850780";"  793648";"   27850";"       0";"       0";"       0";"       0";"       0"
"1635";"A043591";"2014JJ00";"   27023";"   13506";"   13517";" 3956364";" 1974334";" 1982030";" 3956364";" 3872608";" 3562963";"   83756";"       0";"       0";"       0";"       0";"       0"
"1636";"A043591";"2015MM01";"    1844";"     922";"     922";"  247187";"  127672";"  119515";"  247187";"  236407";"  226449";"   10780";"     235";"       0";"       0";"       0";"       0"
"1637";"A043591";"2015MM02";"    1794";"     897";"     897";"  255091";"  123794";"  131297";"  255091";"  245053";"  233813";"   10038";"       0";"       0";"       0";"       0";"       0"
"1638";"A043591";"2015MM03";"    2200";"    1102";"    1098";"  313992";"  157001";"  156991";"  313992";"  302797";"  288258";"   11195";"       0";"       0";"       0";"       0";"       0"
"1639";"A043591";"2015KW01";"    5838";"    2921";"    2917";"  816270";"  408467";"  407803";"  816270";"  784257";"  748520";"   32013";"     235";"       0";"       0";"       0";"       0"
"1640";"A043591";"2015MM04";"    2536";"    1266";"    1270";"  386044";"  184832";"  201212";"  386044";"  374599";"  346026";"   11445";"       0";"       0";"       0";"       0";"       0"
"1641";"A043591";"2015MM05";"    2835";"    1417";"    1418";"  446497";"  223633";"  222864";"  446497";"  437592";"  396055";"    8905";"       0";"       0";"       0";"       0";"       0"
"1642";"A043591";"2015MM06";"    2752";"    1377";"    1375";"  426021";"  211387";"  214634";"  426021";"  418175";"  383188";"    7846";"       0";"       0";"       0";"       0";"       0"
"1643";"A043591";"2015KW02";"    8123";"    4060";"    4063";" 1258562";"  619852";"  638710";" 1258562";" 1230366";" 1125269";"   28196";"       0";"       0";"       0";"       0";"       0"
"1644";"A043591";"2015MM07";"    2855";"    1426";"    1429";"  447582";"  209319";"  238263";"  447582";"  440220";"  401767";"    7362";"       0";"       0";"       0";"       0";"       0"
"1645";"A043591";"2015MM08";"    2851";"    1426";"    1425";"  458138";"  238630";"  219508";"  458138";"  449825";"  410300";"    8313";"       0";"       0";"       0";"       0";"       0"
"1646";"A043591";"2015MM09";"    2741";"    1370";"    1371";"  428748";"  215933";"  212815";"  428748";"  420171";"  384854";"    8577";"       0";"       0";"       0";"       0";"       0"
"1647";"A043591";"2015KW03";"    8447";"    4222";"    4225";" 1334468";"  663882";"  670586";" 1334468";" 1310216";" 1196921";"   24252";"       0";"       0";"       0";"       0";"       0"
"1648";"A043591";"2015MM10";"    2708";"    1354";"    1354";"  421488";"  216939";"  204549";"  421488";"  412545";"  379793";"    8943";"       0";"       0";"       0";"       0";"       0"
"1649";"A043591";"2015MM11";"    1833";"     916";"     917";"  270990";"  140883";"  130107";"  270990";"  260291";"  248133";"   10699";"       0";"       0";"       0";"       0";"       0"
"1650";"A043591";"2015MM12";"    1886";"     944";"     942";"  272104";"  129192";"  142912";"  272104";"  262153";"  250105";"    9951";"       0";"       0";"       0";"       0";"       0"
"1651";"A043591";"2015KW04";"    6427";"    3214";"    3213";"  964582";"  487014";"  477568";"  964582";"  934989";"  878031";"   29593";"       0";"       0";"       0";"       0";"       0"
"1652";"A043591";"2015JJ00";"   28835";"   14417";"   14418";" 4373882";" 2179215";" 2194667";" 4373882";" 4259828";" 3948741";"  114054";"     235";"       0";"       0";"       0";"       0"
"1653";"A043591";"2016MM01";"    1970";"     983";"     987";"  277796";"  143665";"  134131";"  277796";"  269391";"  259509";"    8405";"       0";"       0";"       0";"       0";"       0"
"1654";"A043591";"2016MM02";"    1983";"     992";"     991";"  294491";"  144367";"  150124";"  294491";"  285783";"  277418";"    8708";"       0";"       0";"       0";"       0";"       0"
"1655";"A043591";"2016MM03";"    2402";"    1199";"    1203";"  358055";"  175806";"  182249";"  358055";"  350453";"  337239";"    7602";"       0";"       0";"       0";"       0";"       0"
"1656";"A043591";"2016KW01";"    6355";"    3174";"    3181";"  930342";"  463838";"  466504";"  930342";"  905627";"  874166";"   24715";"       0";"       0";"       0";"       0";"       0"
"1657";"A043591";"2016MM04";"    2780";"    1390";"    1390";"  428556";"  204641";"  223915";"  428556";"  420237";"  402458";"    8319";"       0";"       0";"       0";"       0";"       0"
"1658";"A043591";"2016MM05";"    2945";"    1469";"    1476";"  453348";"  234778";"  218570";"  453348";"  444217";"  418508";"    9131";"       0";"       0";"       0";"       0";"       0"
"1659";"A043591";"2016MM06";"    1542";"     775";"     767";"  231727";"  106523";"  125204";"  231727";"  227713";"  216850";"    4014";"       0";"       0";"       0";"       0";"       0"
"1660";"A043591";"2016KW02";"    7267";"    3634";"    3633";" 1113631";"  545942";"  567689";" 1113631";" 1092167";" 1037816";"   21464";"       0";"       0";"       0";"       0";"       0"
"1661";"A043591";"2016MM07";"    3171";"    1584";"    1587";"  507699";"  239598";"  268101";"  507699";"  499627";"  473074";"    8072";"       0";"       0";"       0";"       0";"       0"
"1662";"A043591";"2016MM08";"    3157";"    1579";"    1578";"  516581";"  266348";"  250233";"  516581";"  507733";"  476271";"    8848";"       0";"       0";"       0";"       0";"       0"
"1663";"A043591";"2016MM09";"    3192";"    1596";"    1596";"  507109";"  256004";"  251105";"  507109";"  498764";"  474106";"    8345";"       0";"       0";"       0";"       0";"       0"
"1664";"A043591";"2016KW03";"    9520";"    4759";"    4761";" 1531389";"  761950";"  769439";" 1531389";" 1506124";" 1423451";"   25265";"       0";"       0";"       0";"       0";"       0"
"1665";"A043591";"2016MM10";"    3096";"    1548";"    1548";"  490112";"  250067";"  240045";"  490112";"  480715";"  458322";"    9397";"       0";"       0";"       0";"       0";"       0"
"1666";"A043591";"2016MM11";"    2340";"    1169";"    1171";"  359269";"  184996";"  174273";"  359269";"  347837";"  337738";"   11432";"       0";"       0";"       0";"       0";"       0"
"1667";"A043591";"2016MM12";"    2332";"    1164";"    1168";"  355454";"  169242";"  186212";"  355454";"  342494";"  331402";"   12960";"       0";"       0";"       0";"       0";"       0"
"1668";"A043591";"2016KW04";"    7768";"    3881";"    3887";" 1204835";"  604305";"  600530";" 1204835";" 1171046";" 1127462";"   33789";"       0";"       0";"       0";"       0";"       0"
"1669";"A043591";"2016JJ00";"   30910";"   15448";"   15462";" 4780197";" 2376035";" 2404162";" 4780197";" 4674964";" 4462895";"  105233";"       0";"       0";"       0";"       0";"       0"
"1670";"A043591";"2017MM01";"    2394";"    1199";"    1195";"  349354";"  180481";"  168873";"  349354";"  336557";"  326194";"   12797";"       0";"       0";"       0";"       0";"       0"
"1671";"A043591";"2017MM02";"    2241";"    1120";"    1121";"  347522";"  168232";"  179290";"  347522";"  336189";"  326028";"   11333";"       0";"       0";"       0";"       0";"       0"
"1672";"A043591";"2017MM03";"    2660";"    1330";"    1330";"  416705";"  208919";"  207786";"  416705";"  403856";"  393156";"   12849";"       0";"       0";"       0";"       0";"       0"
"1673";"A043591";"2017KW01";"    7295";"    3649";"    3646";" 1113581";"  557632";"  555949";" 1113581";" 1076602";" 1045378";"   36979";"       0";"       0";"       0";"       0";"       0"
"1674";"A043591";"2017MM04";"    3059";"    1530";"    1529";"  503029";"  242888";"  260141";"  503029";"  490799";"  473170";"   12230";"       0";"       0";"       0";"       0";"       0"
"1675";"A043591";"2017MM05";"    3302";"    1651";"    1651";"  544797";"  272007";"  272790";"  544797";"  533251";"  511315";"   11546";"       0";"       0";"       0";"       0";"       0"
"1676";"A043591";"2017MM06";"    3233";"    1617";"    1616";"  532103";"  264225";"  267878";"  532103";"  522645";"  500361";"    9458";"       0";"       0";"       0";"       0";"       0"
"1677";"A043591";"2017KW02";"    9594";"    4798";"    4796";" 1579929";"  779120";"  800809";" 1579929";" 1546695";" 1484846";"   33234";"       0";"       0";"       0";"       0";"       0"
"1678";"A043591";"2017MM07";"    3332";"    1666";"    1666";"  567053";"  268137";"  298916";"  567053";"  555499";"  525882";"   11554";"       0";"       0";"       0";"       0";"       0"
"1679";"A043591";"2017MM08";"    3335";"    1668";"    1667";"  577120";"  296811";"  280309";"  577120";"  563967";"  533146";"   13153";"       0";"       0";"       0";"       0";"       0"
"1680";"A043591";"2017MM09";"    3267";"    1633";"    1634";"  553096";"  278361";"  274735";"  553096";"  542224";"  513779";"   10872";"       0";"       0";"       0";"       0";"       0"
"1681";"A043591";"2017KW03";"    9934";"    4967";"    4967";" 1697269";"  843309";"  853960";" 1697269";" 1661690";" 1572807";"   35579";"       0";"       0";"       0";"       0";"       0"
"1682";"A043591";"2017MM10";"    3214";"    1607";"    1607";"  536736";"  274190";"  262546";"  536736";"  524163";"  504180";"   12573";"       0";"       0";"       0";"       0";"       0"
"1683";"A043591";"2017MM11";"    2499";"    1249";"    1250";"  401036";"  207259";"  193777";"  401036";"  382674";"  372136";"   18362";"       0";"    2066";"    2066";"       0";"       0"
"1684";"A043591";"2017MM12";"    2393";"    1197";"    1196";"  372669";"  175621";"  197048";"  372669";"  355774";"  342841";"   16895";"       0";"    2028";"    2028";"       0";"       0"
"1685";"A043591";"2017KW04";"    8106";"    4053";"    4053";" 1310441";"  657070";"  653371";" 1310441";" 1262611";" 1219157";"   47830";"       0";"    4094";"    4094";"       0";"       0"
"1686";"A043591";"2017JJ00";"   34929";"   17467";"   17462";" 5701220";" 2837131";" 2864089";" 5701220";" 5547598";" 5322188";"  153622";"       0";"    4094";"    4094";"       0";"       0"
"1687";"A043591";"2018MM01";"    2615";"    1307";"    1308";"  398089";"  206081";"  192008";"  398089";"  381354";"  368980";"   16735";"       0";"    1322";"    1322";"       0";"       0"
"1688";"A043591";"2018MM02";"    2417";"    1209";"    1208";"  393080";"  191966";"  201114";"  393080";"  375144";"  364777";"   17936";"       0";"    2120";"    2120";"       0";"       0"
"1689";"A043591";"2018MM03";"    2774";"    1386";"    1388";"  452090";"  223641";"  228449";"  452090";"  431857";"  421409";"   20233";"       0";"    2764";"    2764";"       0";"       0"
"1690";"A043591";"2018KW01";"    7806";"    3902";"    3904";" 1243259";"  621688";"  621571";" 1243259";" 1188355";" 1155166";"   54904";"       0";"    6206";"    6206";"       0";"       0"
"1691";"A043591";"2018MM04";"    3151";"    1577";"    1574";"  537248";"  261765";"  275483";"  537248";"  513978";"  497895";"   23270";"       0";"    4349";"    4349";"       0";"       0"
"1692";"A043591";"2018MM05";"    3408";"    1704";"    1704";"  585787";"  291447";"  294340";"  585787";"  562972";"  539248";"   22815";"       0";"    4403";"    4403";"       0";"       0"
"1693";"A043591";"2018MM06";"    3406";"    1703";"    1703";"  583746";"  288433";"  295313";"  583746";"  562550";"  536404";"   21196";"       0";"    4417";"    4417";"       0";"       0"
"1694";"A043591";"2018KW02";"    9965";"    4984";"    4981";" 1706781";"  841645";"  865136";" 1706781";" 1639500";" 1573547";"   67281";"       0";"   13169";"   13169";"       0";"       0"
"1695";"A043591";"2018MM07";"    3592";"    1796";"    1796";"  623708";"  294736";"  328972";"  623708";"  598151";"  567019";"   25557";"       0";"    4641";"    4641";"       0";"       0"
"1696";"A043591";"2018MM08";"    3636";"    1818";"    1818";"  635624";"  327843";"  307781";"  635624";"  606885";"  573854";"   28739";"       0";"    5051";"    5051";"       0";"       0"
"1697";"A043591";"2018MM09";"    3546";"    1773";"    1773";"  615201";"  311332";"  303869";"  615201";"  589550";"  561936";"   25651";"       0";"    3826";"    3826";"       0";"       0"
"1698";"A043591";"2018KW03";"   10774";"    5387";"    5387";" 1874533";"  933911";"  940622";" 1874533";" 1794586";" 1702809";"   79947";"       0";"   13518";"   13518";"       0";"       0"
"1699";"A043591";"2018MM10";"    3590";"    1795";"    1795";"  612905";"  313557";"  299348";"  612905";"  585662";"  559606";"   27243";"       0";"    4738";"    4738";"       0";"       0"
"1700";"A043591";"2018MM11";"    2473";"    1234";"    1239";"  409628";"  209688";"  199940";"  409628";"  383344";"  371022";"   26284";"       0";"    3914";"    3914";"       0";"       0"
"1701";"A043591";"2018MM12";"    2427";"    1214";"    1213";"  390649";"  185943";"  204706";"  390649";"  366861";"  351096";"   23788";"       0";"    2862";"    2862";"       0";"       0"
"1702";"A043591";"2018KW04";"    8490";"    4243";"    4247";" 1413182";"  709188";"  703994";" 1413182";" 1335867";" 1281724";"   77315";"       0";"   11514";"   11514";"       0";"       0"
"1703";"A043591";"2018JJ00";"   37035";"   18516";"   18519";" 6237755";" 3106432";" 3131323";" 6237755";" 5958308";" 5713246";"  279447";"       0";"   44407";"   44407";"       0";"       0"
"1704";"A043591";"2019MM01";"    2579";"    1289";"    1290";"  400481";"  206935";"  193546";"  400481";"  375089";"  358122";"   25392";"       0";"    2605";"    2605";"       0";"       0"
"1705";"A043591";"2019MM02";"    2417";"    1209";"    1208";"  404961";"  198594";"  206367";"  404961";"  378663";"  363725";"   26298";"       0";"    2606";"    2606";"       0";"       0"
"1706";"A043591";"2019MM03";"    2854";"    1427";"    1427";"  486336";"  243926";"  242410";"  486336";"  454150";"  436945";"   32186";"       0";"    4455";"    4455";"       0";"       0"
"1707";"A043591";"2019KW01";"    7850";"    3925";"    3925";" 1291778";"  649455";"  642323";" 1291778";" 1207902";" 1158792";"   83876";"       0";"    9666";"    9666";"       0";"       0"
"1708";"A043591";"2019MM04";"    3573";"    1786";"    1787";"  606490";"  291947";"  314543";"  606490";"  575402";"  542139";"   31088";"       0";"    4592";"    4592";"       0";"       0"
"1709";"A043591";"2019MM05";"    3933";"    1963";"    1970";"  656099";"  326219";"  329880";"  656099";"  631507";"  591522";"   24592";"       0";"    5296";"    5296";"       0";"       0"
"1710";"A043591";"2019MM06";"    3836";"    1919";"    1917";"  657648";"  327515";"  330133";"  657648";"  628373";"  588560";"   29275";"       0";"    5057";"    5057";"       0";"       0"
"1711";"A043591";"2019KW02";"   11342";"    5668";"    5674";" 1920237";"  945681";"  974556";" 1920237";" 1835282";" 1722221";"   84955";"       0";"   14945";"   14945";"       0";"       0"
"1712";"A043591";"2019MM07";"    3922";"    1961";"    1961";"  665638";"  312064";"  353574";"  665638";"  633847";"  587341";"   31791";"       0";"    7021";"    7021";"       0";"       0"
"1713";"A043591";"2019MM08";"    3933";"    1965";"    1968";"  681093";"  351710";"  329383";"  681093";"  648004";"  598181";"   33089";"       0";"    7108";"    7108";"       0";"       0"
"1714";"A043591";"2019MM09";"    3913";"    1952";"    1961";"  672355";"  339392";"  332963";"  672355";"  641495";"  597501";"   30860";"       0";"    5222";"    5222";"       0";"       0"
"1715";"A043591";"2019KW03";"   11768";"    5878";"    5890";" 2019086";" 1003166";" 1015920";" 2019086";" 1923346";" 1783023";"   95740";"       0";"   19351";"   19351";"       0";"       0"
"1716";"A043591";"2019MM10";"    3870";"    1937";"    1933";"  662238";"  339167";"  323071";"  662238";"  630181";"  586648";"   32057";"       0";"    4262";"    4262";"       0";"       0"
"1717";"A043591";"2019MM11";"    2641";"    1315";"    1326";"  446930";"  229154";"  217776";"  446930";"  417528";"  396673";"   29402";"       0";"    4237";"    4237";"       0";"       0"
"1718";"A043591";"2019MM12";"    2738";"    1369";"    1369";"  440506";"  207147";"  233359";"  440506";"  413878";"  391274";"   26628";"       0";"    4015";"    4015";"       0";"       0"
"1719";"A043591";"2019KW04";"    9249";"    4621";"    4628";" 1549674";"  775468";"  774206";" 1549674";" 1461587";" 1374595";"   88087";"       0";"   12514";"   12514";"       0";"       0"
"1720";"A043591";"2019JJ00";"   40209";"   20092";"   20117";" 6780775";" 3373770";" 3407005";" 6780775";" 6428117";" 6038631";"  352658";"       0";"   56476";"   56476";"       0";"       0"
"1721";"A043591";"2020MM01";"    2554";"    1277";"    1277";"  400991";"  202475";"  198516";"  400991";"  375641";"  358273";"   25350";"       0";"    2416";"    2416";"       0";"       0"
"1722";"A043591";"2020MM02";"    2649";"    1328";"    1321";"  438828";"  214069";"  224759";"  438828";"  410047";"  391035";"   28781";"       0";"    3525";"    3525";"       0";"       0"
"1723";"A043591";"2020MM03";"    1888";"     939";"     949";"  225071";"  121612";"  103459";"  225071";"  210026";"  200631";"   15045";"       0";"    1233";"    1233";"       0";"       0"
"1724";"A043591";"2020KW01";"    7091";"    3544";"    3547";" 1064890";"  538156";"  526734";" 1064890";"  995714";"  949939";"   69176";"       0";"    7174";"    7174";"       0";"       0"
"1725";"A043591";"2020MM04";"     148";"      75";"      73";"    7732";"    4740";"    2992";"    7732";"    7732";"    7704";"       0";"       0";"       0";"       0";"       0";"       0"
"1726";"A043591";"2020MM05";"     178";"      92";"      86";"   12108";"    7472";"    4636";"   12108";"   12108";"   11925";"       0";"       0";"       0";"       0";"       0";"       0"
"1727";"A043591";"2020MM06";"     565";"     286";"     279";"   46774";"   19688";"   27086";"   46774";"   46774";"   43061";"       0";"       0";"       0";"       0";"       0";"       0"
"1728";"A043591";"2020KW02";"     891";"     453";"     438";"   66614";"   31900";"   34714";"   66614";"   66614";"   62690";"       0";"       0";"       0";"       0";"       0";"       0"
"1729";"A043591";"2020MM07";"    2292";"    1152";"    1140";"  257515";"  112453";"  145062";"  257515";"  257515";"  248672";"       0";"       0";"       0";"       0";"       0";"       0"
"1730";"A043591";"2020MM08";"    2713";"    1352";"    1361";"  295053";"  162305";"  132748";"  295053";"  295053";"  286207";"       0";"       0";"       0";"       0";"       0";"       0"
"1731";"A043591";"2020MM09";"    1947";"     973";"     974";"  171375";"   90205";"   81170";"  171375";"  171375";"  164985";"       0";"       0";"       0";"       0";"       0";"       0"
"1732";"A043591";"2020KW03";"    6952";"    3477";"    3475";"  723943";"  364963";"  358980";"  723943";"  723943";"  699864";"       0";"       0";"       0";"       0";"       0";"       0"
"1733";"A043591";"2020MM10";"    1451";"     724";"     727";"  133057";"   68212";"   64845";"  133057";"  133057";"  127633";"       0";"       0";"       0";"       0";"       0";"       0"
"1734";"A043591";"2020MM11";"     721";"     363";"     358";"   57737";"   31566";"   26171";"   57737";"   57737";"   54090";"       0";"       0";"       0";"       0";"       0";"       0"
"1735";"A043591";"2020MM12";"     769";"     387";"     382";"   66544";"   26518";"   40026";"   66544";"   66544";"   62078";"       0";"       0";"       0";"       0";"       0";"       0"
"1736";"A043591";"2020KW04";"    2941";"    1474";"    1467";"  257338";"  126296";"  131042";"  257338";"  257338";"  243801";"       0";"       0";"       0";"       0";"       0";"       0"
"1737";"A043591";"2020JJ00";"   17875";"    8948";"    8927";" 2112785";" 1061315";" 1051470";" 2112785";" 2043609";" 1956294";"   69176";"       0";"    7174";"    7174";"       0";"       0"
"1738";"A043591";"2021MM01";"     572";"     282";"     290";"   36128";"   22761";"   13367";"   36128";"   36128";"   32218";"       0";"       0";"       0";"       0";"       0";"       0"
"1739";"A043591";"2021MM02";"     169";"      86";"      83";"   11314";"    5599";"    5715";"   11314";"   10985";"    9366";"     329";"       0";"       0";"       0";"       0";"       0"
"1740";"A043591";"2021MM03";"     226";"     114";"     112";"   16000";"    7397";"    8603";"   16000";"   16000";"   13688";"       0";"       0";"       0";"       0";"       0";"       0"
"1741";"A043591";"2021KW01";"     967";"     482";"     485";"   63442";"   35757";"   27685";"   63442";"   63113";"   55272";"     329";"       0";"       0";"       0";"       0";"       0"
"1742";"A043591";"2021MM04";"     373";"     190";"     183";"   27805";"   12367";"   15438";"   27805";"   27805";"   23870";"       0";"       0";"       0";"       0";"       0";"       0"
"1743";"A043591";"2021MM05";"     562";"     280";"     282";"   51798";"   24310";"   27488";"   51798";"   51798";"   45658";"       0";"       0";"       0";"       0";"       0";"       0"
"1744";"A043591";"2021MM06";"    1428";"     722";"     706";"  147608";"   65258";"   82350";"  147608";"  142960";"  135698";"    4648";"       0";"       0";"       0";"       0";"       0"
"1745";"A043591";"2021KW02";"    2363";"    1192";"    1171";"  227211";"  101935";"  125276";"  227211";"  222563";"  205226";"    4648";"       0";"       0";"       0";"       0";"       0"
"1746";"A043591";"2021MM07";"    2779";"    1396";"    1383";"  344808";"  149673";"  195135";"  344808";"  328995";"  300153";"   15813";"       0";"       0";"       0";"       0";"       0"
"1747";"A043591";"2021MM08";"    3245";"    1616";"    1629";"  481576";"  252858";"  228718";"  481576";"  460773";"  423054";"   20803";"       0";"       0";"       0";"       0";"       0"
"1748";"A043591";"2021MM09";"    3112";"    1555";"    1557";"  453527";"  233057";"  220470";"  453527";"  440601";"  414376";"   12926";"       0";"       0";"       0";"       0";"       0"
"1749";"A043591";"2021KW03";"    9136";"    4567";"    4569";" 1279911";"  635588";"  644323";" 1279911";" 1230369";" 1137583";"   49542";"       0";"       0";"       0";"       0";"       0"
"1750";"A043591";"2021MM10";"    3097";"    1550";"    1547";"  479966";"  242080";"  237886";"  479966";"  470038";"  438627";"    9928";"       0";"       0";"       0";"       0";"       0"
"1751";"A043591";"2021MM11";"    2390";"    1192";"    1198";"  341640";"  177372";"  164268";"  341640";"  341299";"  306538";"     341";"       0";"       0";"       0";"       0";"       0"
"1752";"A043591";"2021MM12";"    2571";"    1291";"    1280";"  306254";"  133388";"  172866";"  306254";"  305997";"  273536";"     257";"       0";"     257";"     257";"       0";"       0"
"1753";"A043591";"2021KW04";"    8058";"    4033";"    4025";" 1127860";"  552840";"  575020";" 1127860";" 1117334";" 1018701";"   10526";"       0";"     257";"     257";"       0";"       0"
"1754";"A043591";"2021JJ00";"   20524";"   10274";"   10250";" 2698424";" 1326120";" 1372304";" 2698424";" 2633379";" 2416782";"   65045";"       0";"     257";"     257";"       0";"       0"
"1755";"A043591";"2022MM01";"    2133";"    1062";"    1071";"  275066";"  149639";"  125427";"  275066";"  275066";"  246530";"       0";"       0";"       0";"       0";"       0";"       0"
"1756";"A043591";"2022MM02";"    2151";"    1081";"    1070";"  309283";"  148530";"  160753";"  309283";"  305034";"  272357";"    4249";"       0";"     231";"     231";"       0";"       0"
"1757";"A043591";"2022MM03";"    2700";"    1346";"    1354";"  401775";"  203066";"  198709";"  401775";"  393052";"  348500";"    8723";"       0";"       0";"       0";"       0";"       0"
"1758";"A043591";"2022KW01";"    6984";"    3489";"    3495";"  986124";"  501235";"  484889";"  986124";"  973152";"  867387";"   12972";"       0";"     231";"     231";"       0";"       0"
"1759";"A043591";"2022MM04";"    3390";"    1702";"    1688";"  545981";"  259702";"  286279";"  545981";"  536134";"  473894";"    9847";"       0";"       0";"       0";"       0";"       0"
"1760";"A043591";"2022MM05";"    3768";"    1884";"    1884";"  618681";"  308586";"  310095";"  618681";"  603677";"  535103";"   15004";"       0";"       0";"       0";"       0";"       0"
"1761";"A043591";"2022MM06";"    3724";"    1858";"    1866";"  631243";"  307267";"  323976";"  631243";"  614908";"  546371";"   16335";"       0";"       0";"       0";"       0";"       0"
"1762";"A043591";"2022KW02";"   10882";"    5444";"    5438";" 1795905";"  875555";"  920350";" 1795905";" 1754719";" 1555368";"   41186";"       0";"       0";"       0";"       0";"       0"
"1763";"A043591";"2022MM07";"    3909";"    1954";"    1955";"  662646";"  311307";"  351339";"  662646";"  643419";"  559862";"   19227";"       0";"       0";"       0";"       0";"       0"
"1764";"A043591";"2022MM08";"    3948";"    1970";"    1978";"  678848";"  350974";"  327874";"  678848";"  659980";"  569459";"   18868";"      31";"       0";"       0";"       0";"       0"
"1765";"A043591";"2022MM09";"    3800";"    1901";"    1899";"  636581";"  320394";"  316187";"  636581";"  620735";"  543068";"   15846";"       0";"       0";"       0";"       0";"       0"
"1766";"A043591";"2022KW03";"   11657";"    5825";"    5832";" 1978075";"  982675";"  995400";" 1978075";" 1924134";" 1672389";"   53941";"      31";"       0";"       0";"       0";"       0"
"1767";"A043591";"2022MM10";"    3935";"    1963";"    1972";"  669753";"  338590";"  331163";"  669753";"  647591";"  560191";"   22162";"       0";"       0";"       0";"       0";"       0"
"1768";"A043591";"2022MM11";"    2683";"    1337";"    1346";"  448417";"  231369";"  217048";"  448417";"  430295";"  375554";"   18122";"       0";"       0";"       0";"       0";"       0"
"1769";"A043591";"2022MM12";"    2838";"    1423";"    1415";"  452325";"  209040";"  243285";"  452325";"  434389";"  379816";"   17936";"       0";"     176";"     176";"       0";"       0"
"1770";"A043591";"2022KW04";"    9456";"    4723";"    4733";" 1570495";"  778999";"  791496";" 1570495";" 1512275";" 1315561";"   58220";"       0";"     176";"     176";"       0";"       0"
"1771";"A043591";"2022JJ00";"   38979";"   19481";"   19498";" 6330599";" 3138464";" 3192135";" 6330599";" 6164280";" 5410705";"  166319";"      31";"     407";"     407";"       0";"       0"
"1772";"A043591";"2023MM01";"    2843";"    1418";"    1425";"  452713";"  237296";"  215417";"  452713";"  435133";"  381011";"   17580";"       0";"     181";"     181";"       0";"       0"
"1773";"A043591";"2023MM02";"    2565";"    1286";"    1279";"  425978";"  205993";"  219985";"  425978";"  410062";"  361259";"   15916";"       0";"       0";"       0";"       0";"       0"
"1774";"A043591";"2023MM03";"    2970";"    1481";"    1489";"  503693";"  249548";"  254145";"  503693";"  484924";"  428128";"   18769";"       0";"       0";"       0";"       0";"       0"
"1775";"A043591";"2023KW01";"    8378";"    4185";"    4193";" 1382384";"  692837";"  689547";" 1382384";" 1330119";" 1170398";"   52265";"       0";"     181";"     181";"       0";"       0"
"1776";"A043591";"2023MM04";"    3495";"    1747";"    1748";"  597756";"  287605";"  310151";"  597756";"  581582";"  512294";"   16174";"       0";"       0";"       0";"       0";"       0"
"1777";"A043591";"2023MM05";"    3864";"    1929";"    1935";"  664708";"  332667";"  332041";"  664708";"  644097";"  561995";"   20611";"       0";"       0";"       0";"       0";"       0"
"1778";"A043591";"2023MM06";"    3774";"    1888";"    1886";"  640577";"  313569";"  327008";"  640577";"  620844";"  543703";"   19733";"       0";"       0";"       0";"       0";"       0"
"1779";"A043591";"2023KW02";"   11133";"    5564";"    5569";" 1903041";"  933841";"  969200";" 1903041";" 1846523";" 1617992";"   56518";"       0";"       0";"       0";"       0";"       0"
"1780";"A043591";"2023MM07";"    3915";"    1952";"    1963";"  671051";"  316732";"  354319";"  671051";"  646436";"  559095";"   24615";"       0";"       0";"       0";"       0";"       0"
"1781";"A043591";"2023MM08";"    3929";"    1961";"    1968";"  680983";"  352962";"  328021";"  680983";"  656542";"  566420";"   24441";"       0";"       0";"       0";"       0";"       0"
"1782";"A043591";"2023MM09";"    3941";"    1969";"    1972";"  667278";"  334875";"  332403";"  667278";"  646998";"  565387";"   20280";"       0";"       0";"       0";"       0";"       0"
"1783";"A043591";"2023KW03";"   11785";"    5882";"    5903";" 2019312";" 1004569";" 1014743";" 2019312";" 1949976";" 1690902";"   69336";"       0";"       0";"       0";"       0";"       0"
"1784";"A043591";"2023MM10";"    3803";"    1901";"    1902";"  661976";"  338262";"  323714";"  661976";"  641645";"  559670";"   20331";"       0";"       0";"       0";"       0";"       0"
"1785";"A043591";"2023MM11";"    2645";"    1322";"    1323";"  456544";"  233434";"  223110";"  456544";"  437491";"  377231";"   19053";"       0";"       0";"       0";"       0";"       0"
"1786";"A043591";"2023MM12";"    2800";"    1403";"    1397";"  453660";"  209774";"  243886";"  453660";"  435695";"  367633";"   17965";"       0";"       0";"       0";"       0";"       0"
"1787";"A043591";"2023KW04";"    9248";"    4626";"    4622";" 1572180";"  781470";"  790710";" 1572180";" 1514831";" 1304534";"   57349";"       0";"       0";"       0";"       0";"       0"
"1788";"A043591";"2023JJ00";"   40544";"   20257";"   20287";" 6876917";" 3412717";" 3464200";" 6876917";" 6641449";" 5783826";"  235468";"       0";"     181";"     181";"       0";"       0"
"1789";"A043591";"2024MM01";"    2755";"    1378";"    1377";"  443501";"  232486";"  211015";"  443501";"  424370";"  361521";"   19131";"       0";"     363";"     363";"       0";"       0"
"1790";"A043591";"2024MM02";"    2695";"    1344";"    1351";"  456692";"  223701";"  232991";"  456692";"  437397";"  379420";"   19295";"       0";"     167";"     167";"       0";"       0"
"1791";"A043591";"2024MM03";"    2971";"    1487";"    1484";"  505130";"  249405";"  255725";"  505130";"  488323";"  424617";"   16807";"       0";"     163";"     163";"       0";"       0"
"1792";"A043591";"2024KW01";"    8421";"    4209";"    4212";" 1405323";"  705592";"  699731";" 1405323";" 1350090";" 1165558";"   55233";"       0";"     693";"     693";"       0";"       0"
"1793";"A043591";"2024MM04";"    3552";"    1778";"    1774";"  610342";"  294726";"  315616";"  610342";"  592984";"  524450";"   17358";"       0";"       0";"       0";"       0";"       0"
"1794";"A043591";"2024MM05";"    3885";"    1943";"    1942";"  688046";"  343698";"  344348";"  688046";"  664986";"  583536";"   23060";"       0";"       0";"       0";"       0";"       0"
"1795";"A043591";"2024MM06";"    3743";"    1871";"    1872";"  658426";"  324560";"  333866";"  658426";"  636910";"  559611";"   21516";"       0";"       0";"       0";"       0";"       0"
"1796";"A043591";"2024KW02";"   11180";"    5592";"    5588";" 1956814";"  962984";"  993830";" 1956814";" 1894880";" 1667597";"   61934";"       0";"       0";"       0";"       0";"       0"
"1797";"A043591";"2024MM07";"    3735";"    1872";"    1863";"  651651";"  305914";"  345737";"  651651";"  629594";"  549307";"   22057";"       0";"      60";"      60";"       0";"       0"
"1798";"A043591";"2024MM08";"    3628";"    1812";"    1816";"  648552";"  334318";"  314234";"  648552";"  627177";"  544001";"   21375";"       0";"      58";"      58";"       0";"       0"
"1799";"A043591";"2024MM09";"    3726";"    1861";"    1865";"  650478";"  325818";"  324660";"  650478";"  629812";"  552925";"   20666";"       0";"       0";"       0";"       0";"       0"
"1800";"A043591";"2024KW03";"   11089";"    5545";"    5544";" 1950681";"  966050";"  984631";" 1950681";" 1886583";" 1646233";"   64098";"       0";"     118";"     118";"       0";"       0"
"1801";"A043591";"2024MM10";"    3708";"    1855";"    1853";"  652775";"  328842";"  323933";"  652775";"  631158";"  552448";"   21617";"       0";"       0";"       0";"       0";"       0"
"1802";"A043591";"2024MM11";"    2672";"    1338";"    1334";"  456393";"  233741";"  222652";"  456393";"  433044";"  371424";"   23349";"       0";"       0";"       0";"       0";"       0"
"1803";"A043591";"2024MM12";"    2656";"    1329";"    1327";"  437158";"  202087";"  235071";"  437158";"  414903";"  350293";"   22255";"       0";"       0";"       0";"       0";"       0"
"1804";"A043591";"2024KW04";"    9036";"    4522";"    4514";" 1546326";"  764670";"  781656";" 1546326";" 1479105";" 1274165";"   67221";"       0";"       0";"       0";"       0";"       0"
"1805";"A043591";"2024JJ00";"   39726";"   19868";"   19858";" 6859144";" 3399296";" 3459848";" 6859144";" 6610658";" 5753553";"  248486";"       0";"     811";"     811";"       0";"       0"
"1806";"A043591";"2025MM01";"    2531";"    1258";"    1273";"  418306";"  214102";"  204204";"  418306";"  395597";"  336940";"   22709";"       0";"     165";"     165";"       0";"       0"
"1807";"A043591";"2025MM02";"    2549";"    1277";"    1272";"  433794";"  211243";"  222551";"  433794";"  409091";"  353915";"   24703";"       0";"       0";"       0";"       0";"       0"
"1808";"A043591";"2025MM03";"    3029";"    1514";"    1515";"  514632";"  256822";"  257810";"  514632";"  490113";"  428956";"   24519";"       0";"       0";"       0";"       0";"       0"
"1809";"A043591";"2025KW01";"    8109";"    4049";"    4060";" 1366732";"  682167";"  684565";" 1366732";" 1294801";" 1119811";"   71931";"       0";"     165";"     165";"       0";"       0"
"1810";"A043591";"2025MM04";"    3618";"    1814";"    1804";"  627742";"  299819";"  327923";"  627742";"  605068";"  534416";"   22674";"       0";"       0";"       0";"       0";"       0"
"1811";"A043591";"2025MM05";"    3944";"    1969";"    1975";"  697867";"  346598";"  351269";"  697867";"  672736";"  594208";"   25131";"       0";"       0";"       0";"       0";"       0"
"1812";"A043591";"2025MM06";"    3766";"    1884";"    1882";"  673639";"  335104";"  338535";"  673639";"  649184";"  573965";"   24454";"       0";"       0";"       0";"       0";"       0"
"1813";"A043591";"2025KW02";"   11328";"    5667";"    5661";" 1999248";"  981521";" 1017727";" 1999248";" 1926988";" 1702589";"   72259";"       0";"       0";"       0";"       0";"       0"
"1814";"A043591";"2025MM07";"    3804";"    1903";"    1901";"  663415";"  311042";"  352373";"  663415";"  639976";"  562860";"   23439";"       0";"     105";"     105";"       0";"       0"
"1815";"A043591";"2025MM08";"    3848";"    1918";"    1930";"  695780";"  357581";"  338199";"  695780";"  667653";"  585729";"   28127";"       0";"       0";"       0";"       0";"       0"
"1816";"A043595";"1997JJ00";"    9072";"    4549";"    4523";"  231908";"  115769";"  116139";"  231908";"  230447";"  198620";"    1461";"       0";"       0";"       0";"       0";"       0"
"1817";"A043595";"1998JJ00";"    8679";"    4366";"    4313";"  240657";"  121666";"  118991";"  240657";"  239615";"  204970";"    1042";"       0";"       0";"       0";"       0";"       0"
"1818";"A043595";"1999MM01";"     693";"     350";"     343";"   12241";"    6448";"    5793";"   12241";"   12192";"   11390";"      49";"       0";"       0";"       0";"       0";"       0"
"1819";"A043595";"1999MM02";"     657";"     329";"     328";"   13813";"    7037";"    6776";"   13813";"   13637";"   12716";"     176";"       0";"       0";"       0";"       0";"       0"
"1820";"A043595";"1999MM03";"     781";"     390";"     391";"   14769";"    7433";"    7336";"   14769";"   14637";"   14271";"     132";"       0";"       0";"       0";"       0";"       0"
"1821";"A043595";"1999KW01";"    2131";"    1069";"    1062";"   40823";"   20918";"   19905";"   40823";"   40466";"   38377";"     357";"       0";"       0";"       0";"       0";"       0"
"1822";"A043595";"1999MM04";"     753";"     378";"     375";"   16449";"    7484";"    8965";"   16449";"   16080";"   15367";"     369";"       0";"       0";"       0";"       0";"       0"
"1823";"A043595";"1999MM05";"     925";"     464";"     461";"   30875";"   14655";"   16220";"   30875";"   30631";"   29489";"     244";"       0";"       0";"       0";"       0";"       0"
"1824";"A043595";"1999MM06";"     977";"     492";"     485";"   32141";"   14437";"   17704";"   32141";"   31966";"   28006";"     175";"       0";"       0";"       0";"       0";"       0"
"1825";"A043595";"1999KW02";"    2655";"    1334";"    1321";"   79465";"   36576";"   42889";"   79465";"   78677";"   72862";"     788";"       0";"       0";"       0";"       0";"       0"
"1826";"A043595";"1999MM07";"     966";"     484";"     482";"   39008";"   17298";"   21710";"   39008";"   38850";"   30493";"     158";"       0";"       0";"       0";"       0";"       0"
"1827";"A043595";"1999MM08";"     958";"     481";"     477";"   37868";"   22320";"   15548";"   37868";"   36879";"   28404";"     989";"       0";"       0";"       0";"       0";"       0"
"1828";"A043595";"1999MM09";"     907";"     453";"     454";"   34732";"   18176";"   16556";"   34732";"   34550";"   31509";"     182";"       0";"       0";"       0";"       0";"       0"
"1829";"A043595";"1999KW03";"    2831";"    1418";"    1413";"  111608";"   57794";"   53814";"  111608";"  110279";"   90406";"    1329";"       0";"       0";"       0";"       0";"       0"
"1830";"A043595";"1999MM10";"     898";"     451";"     447";"   28371";"   15556";"   12815";"   28371";"   28151";"   27529";"     220";"       0";"       0";"       0";"       0";"       0"
"1831";"A043595";"1999MM11";"     826";"     415";"     411";"   18469";"    9481";"    8988";"   18469";"   17965";"   16909";"     504";"       0";"       0";"       0";"       0";"       0"
"1832";"A043595";"1999MM12";"     832";"     418";"     414";"   14552";"    7527";"    7025";"   14552";"   13713";"   13445";"     839";"       0";"       0";"       0";"       0";"       0"
"1833";"A043595";"1999KW04";"    2556";"    1284";"    1272";"   61392";"   32564";"   28828";"   61392";"   59829";"   57883";"    1563";"       0";"       0";"       0";"       0";"       0"
"1834";"A043595";"1999JJ00";"   10173";"    5105";"    5068";"  293288";"  147852";"  145436";"  293288";"  289251";"  259528";"    4037";"       0";"       0";"       0";"       0";"       0"
"1835";"A043595";"2000MM01";"     783";"     388";"     395";"   16605";"    7250";"    9355";"   16605";"   15672";"   14428";"     933";"       0";"       0";"       0";"       0";"       0"
"1836";"A043595";"2000MM02";"     890";"     445";"     445";"   16167";"    6775";"    9392";"   16167";"   15544";"   14889";"     623";"       0";"       0";"       0";"       0";"       0"
"1837";"A043595";"2000MM03";"     952";"     482";"     470";"   20566";"    8964";"   11602";"   20566";"   19343";"   18428";"    1221";"       0";"       0";"       0";"       0";"       0"
"1838";"A043595";"2000KW01";"    2625";"    1315";"    1310";"   53338";"   22989";"   30349";"   53338";"   50559";"   47745";"    2777";"       0";"       0";"       0";"       0";"       0"
"1839";"A043595";"2000MM04";"     962";"     481";"     481";"   22148";"    9065";"   13083";"   22148";"   21453";"   20553";"     691";"       0";"       0";"       0";"       0";"       0"
"1840";"A043595";"2000MM05";"    1256";"     628";"     628";"   41121";"   17945";"   23176";"   41121";"   41116";"   36541";"       1";"       0";"       0";"       0";"       0";"       0"
"1841";"A043595";"2000MM06";"    1244";"     625";"     619";"   48246";"   21355";"   26891";"   48246";"   48246";"   39491";"       0";"       0";"       0";"       0";"       0";"       0"
"1842";"A043595";"2000KW02";"    3462";"    1734";"    1728";"  111515";"   48365";"   63150";"  111515";"  110815";"   96585";"     692";"       0";"       1";"       1";"       0";"       0"
"1843";"A043595";"2000MM07";"    1251";"     623";"     628";"   51872";"   21302";"   30570";"   51872";"   51870";"   38621";"       2";"       0";"       0";"       0";"       0";"       0"
"1844";"A043595";"2000MM08";"    1269";"     640";"     629";"   45354";"   23911";"   21443";"   45354";"   45354";"   33415";"       0";"       0";"       0";"       0";"       0";"       0"
"1845";"A043595";"2000MM09";"    1188";"     593";"     595";"   45540";"   21166";"   24374";"   45540";"   45540";"   39469";"       0";"       0";"       0";"       0";"       0";"       0"
"1846";"A043595";"2000KW03";"    3708";"    1856";"    1852";"  142766";"   66379";"   76387";"  142766";"  142764";"  111505";"       2";"       0";"       0";"       0";"       0";"       0"
"1847";"A043595";"2000MM10";"    1244";"     619";"     625";"   36927";"   18578";"   18349";"   36927";"   36927";"   33582";"       0";"       0";"       0";"       0";"       0";"       0"
"1848";"A043595";"2000MM11";"    1133";"     558";"     575";"   20366";"    9442";"   10924";"   20366";"   20359";"   20156";"       0";"       0";"       0";"       0";"       0";"       0"
"1849";"A043595";"2000MM12";"    1008";"     505";"     503";"   17984";"    8165";"    9819";"   17984";"   17984";"   17021";"       0";"       0";"       0";"       0";"       0";"       0"
"1850";"A043595";"2000KW04";"    3385";"    1682";"    1703";"   75277";"   36185";"   39092";"   75277";"   75270";"   70759";"       0";"       0";"       0";"       0";"       0";"       0"
"1851";"A043595";"2000JJ00";"   13180";"    6587";"    6593";"  382896";"  173918";"  208978";"  382896";"  379408";"  326594";"    3471";"       0";"       1";"       1";"       0";"       0"
"1852";"A043595";"2001MM01";"    1241";"     621";"     620";"   19298";"    9165";"   10133";"   19298";"   19298";"   18764";"       0";"       0";"       0";"       0";"       0";"       0"
"1853";"A043595";"2001MM02";"    1085";"     544";"     541";"   18992";"    8356";"   10636";"   18992";"   18987";"   18966";"       3";"       0";"       0";"       0";"       0";"       0"
"1854";"A043595";"2001MM03";"    1169";"     584";"     585";"   22564";"   10246";"   12318";"   22564";"   22562";"   21799";"       0";"       0";"       0";"       0";"       0";"       0"
"1855";"A043595";"2001KW01";"    3495";"    1749";"    1746";"   60854";"   27767";"   33087";"   60854";"   60847";"   59529";"       3";"       0";"       0";"       0";"       0";"       0"
"1856";"A043595";"2001MM04";"     949";"     477";"     472";"   22536";"    9182";"   13354";"   22536";"   22536";"   21257";"       0";"       0";"       0";"       0";"       0";"       0"
"1857";"A043595";"2001MM05";"    1138";"     567";"     571";"   40072";"   16645";"   23427";"   40072";"   40046";"   33642";"       0";"       0";"       0";"       0";"       0";"       0"
"1858";"A043595";"2001MM06";"    1092";"     545";"     547";"   41049";"   17959";"   23090";"   41049";"   41049";"   34833";"       0";"       0";"       0";"       0";"       0";"       0"
"1859";"A043595";"2001KW02";"    3179";"    1589";"    1590";"  103657";"   43786";"   59871";"  103657";"  103631";"   89732";"       0";"       0";"       0";"       0";"       0";"       0"
"1860";"A043595";"2001MM07";"    1157";"     580";"     577";"   45029";"   18822";"   26207";"   45029";"   45027";"   32852";"       0";"       0";"       0";"       0";"       0";"       0"
"1861";"A043595";"2001MM08";"    1134";"     570";"     564";"   42178";"   20717";"   21461";"   42178";"   42178";"   31066";"       0";"       0";"       0";"       0";"       0";"       0"
"1862";"A043595";"2001MM09";"    1099";"     558";"     541";"   40793";"   17472";"   23321";"   40793";"   40786";"   33356";"       0";"       0";"       0";"       0";"       0";"       0"
"1863";"A043595";"2001KW03";"    3390";"    1708";"    1682";"  128000";"   57011";"   70989";"  128000";"  127991";"   97274";"       0";"       0";"       0";"       0";"       0";"       0"
"1864";"A043595";"2001MM10";"    1130";"     570";"     560";"   35838";"   17352";"   18486";"   35838";"   35838";"   28693";"       0";"       0";"       0";"       0";"       0";"       0"
"1865";"A043595";"2001MM11";"     771";"     389";"     382";"   17534";"    7990";"    9544";"   17534";"   17288";"   17076";"     246";"       0";"       0";"       0";"       0";"       0"
"1866";"A043595";"2001MM12";"     665";"     334";"     331";"   13676";"    6115";"    7561";"   13676";"   12958";"   12947";"     718";"       0";"       2";"       2";"       0";"       0"
"1867";"A043595";"2001KW04";"    2566";"    1293";"    1273";"   67048";"   31457";"   35591";"   67048";"   66084";"   58716";"     964";"       0";"       2";"       2";"       0";"       0"
"1868";"A043595";"2001JJ00";"   12630";"    6339";"    6291";"  359559";"  160021";"  199538";"  359559";"  358553";"  305251";"     967";"       0";"       2";"       2";"       0";"       0"
"1869";"A043595";"2002MM01";"     792";"     398";"     394";"   14880";"    7059";"    7821";"   14880";"   13523";"   13333";"    1357";"       0";"       0";"       0";"       0";"       0"
"1870";"A043595";"2002MM02";"     740";"     372";"     368";"   16444";"    7618";"    8826";"   16444";"   14624";"   14600";"    1780";"       0";"     232";"     232";"       0";"       0"
"1871";"A043595";"2002MM03";"     819";"     412";"     407";"   18178";"    8783";"    9395";"   18178";"   16809";"   16631";"    1362";"       0";"       0";"       0";"       0";"       0"
"1872";"A043595";"2002KW01";"    2351";"    1182";"    1169";"   49502";"   23460";"   26042";"   49502";"   44956";"   44564";"    4499";"       0";"     232";"     232";"       0";"       0"
"1873";"A043595";"2002MM04";"     772";"     386";"     386";"   21399";"    8383";"   13016";"   21399";"   20182";"   18283";"    1213";"       0";"       0";"       0";"       0";"       0"
"1874";"A043595";"2002MM05";"     814";"     408";"     406";"   40781";"   15858";"   24923";"   40781";"   40188";"   30600";"     593";"       1";"       5";"       5";"       0";"       0"
"1875";"A043595";"2002MM06";"     822";"     410";"     412";"   33545";"   14028";"   19517";"   33545";"   32748";"   26073";"     785";"       0";"       0";"       0";"       0";"       0"
"1876";"A043595";"2002KW02";"    2408";"    1204";"    1204";"   95725";"   38269";"   57456";"   95725";"   93118";"   74956";"    2591";"       1";"       5";"       5";"       0";"       0"
"1877";"A043595";"2002MM07";"     847";"     422";"     425";"   37349";"   14219";"   23130";"   37349";"   37349";"   26805";"       0";"       0";"       0";"       0";"       0";"       0"
"1878";"A043595";"2002MM08";"     777";"     387";"     390";"   34164";"   15512";"   18652";"   34164";"   34140";"   26355";"      24";"       0";"       0";"       0";"       0";"       0"
"1879";"A043595";"2002MM09";"     871";"     430";"     441";"   36059";"   14705";"   21354";"   36059";"   36037";"   27408";"      22";"      17";"       5";"       5";"       0";"       0"
"1880";"A043595";"2002KW03";"    2495";"    1239";"    1256";"  107572";"   44436";"   63136";"  107572";"  107526";"   80568";"      46";"      17";"       5";"       5";"       0";"       0"
"1881";"A043595";"2002MM10";"     794";"     397";"     397";"   31260";"   15071";"   16189";"   31260";"   31260";"   21375";"       0";"       0";"       0";"       0";"       0";"       0"
"1882";"A043595";"2002MM11";"     624";"     314";"     310";"   15718";"    6801";"    8917";"   15718";"   15705";"   15600";"      13";"       0";"       8";"       4";"       4";"       0"
"1883";"A043595";"2002MM12";"     537";"     267";"     270";"   12556";"    4934";"    7622";"   12556";"   12542";"   12538";"       0";"       0";"       0";"       0";"       0";"       0"
"1884";"A043595";"2002KW04";"    1955";"     978";"     977";"   59534";"   26806";"   32728";"   59534";"   59507";"   49513";"      13";"       0";"       8";"       4";"       4";"       0"
"1885";"A043595";"2002JJ00";"    9209";"    4603";"    4606";"  312333";"  132971";"  179362";"  312333";"  305107";"  249601";"    7149";"      18";"     250";"     246";"       4";"       0"
"1886";"A043595";"2003MM01";"     580";"     291";"     289";"   10018";"    4911";"    5107";"   10018";"   10018";"   10018";"       0";"       0";"       0";"       0";"       0";"       0"
"1887";"A043595";"2003MM02";"     566";"     283";"     283";"   10882";"    5340";"    5542";"   10882";"   10882";"   10882";"       0";"       0";"       0";"       0";"       0";"       0"
"1888";"A043595";"2003MM03";"     626";"     310";"     316";"   12445";"    6600";"    5845";"   12445";"   11963";"   11961";"     482";"     197";"       0";"       0";"       0";"       0"
"1889";"A043595";"2003KW01";"    1772";"     884";"     888";"   33345";"   16851";"   16494";"   33345";"   32863";"   32861";"     482";"     197";"       0";"       0";"       0";"       0"
"1890";"A043595";"2003MM04";"     574";"     288";"     286";"   12390";"    4767";"    7623";"   12390";"   12390";"   10488";"       0";"       0";"       0";"       0";"       0";"       0"
"1891";"A043595";"2003MM05";"     706";"     354";"     352";"   33450";"   15974";"   17476";"   33450";"   33448";"   26934";"       2";"       0";"       2";"       2";"       0";"       0"
"1892";"A043595";"2003MM06";"     682";"     338";"     344";"   32008";"   16517";"   15491";"   32008";"   32008";"   25512";"       0";"       0";"       0";"       0";"       0";"       0"
"1893";"A043595";"2003KW02";"    1962";"     980";"     982";"   77848";"   37258";"   40590";"   77848";"   77846";"   62934";"       2";"       0";"       2";"       2";"       0";"       0"
"1894";"A043595";"2003MM07";"     666";"     334";"     332";"   29193";"   13113";"   16080";"   29193";"   29193";"   22877";"       0";"       0";"       0";"       0";"       0";"       0"
"1895";"A043595";"2003MM08";"     662";"     330";"     332";"   38545";"   20270";"   18275";"   38545";"   38545";"   29708";"       0";"       0";"       0";"       0";"       0";"       0"
"1896";"A043595";"2003MM09";"     795";"     397";"     398";"   34056";"   16588";"   17468";"   34056";"   34053";"   25931";"       3";"       3";"       0";"       0";"       0";"       0"
"1897";"A043595";"2003KW03";"    2123";"    1061";"    1062";"  101794";"   49971";"   51823";"  101794";"  101791";"   78516";"       3";"       3";"       0";"       0";"       0";"       0"
"1898";"A043595";"2003MM10";"     697";"     349";"     348";"   30136";"   16317";"   13819";"   30136";"   30136";"   22796";"       0";"       0";"       0";"       0";"       0";"       0"
"1899";"A043595";"2003MM11";"     655";"     329";"     326";"   16029";"    8259";"    7770";"   16029";"   16025";"   15333";"       4";"       0";"       0";"       0";"       0";"       0"
"1900";"A043595";"2003MM12";"     589";"     293";"     296";"   14195";"    6912";"    7283";"   14195";"   14195";"   14115";"       0";"       0";"       0";"       0";"       0";"       0"
"1901";"A043595";"2003KW04";"    1941";"     971";"     970";"   60360";"   31488";"   28872";"   60360";"   60356";"   52244";"       4";"       0";"       0";"       0";"       0";"       0"
"1902";"A043595";"2003JJ00";"    7798";"    3896";"    3902";"  273347";"  135568";"  137779";"  273347";"  272856";"  226555";"     491";"     200";"       2";"       2";"       0";"       0"
"1903";"A043595";"2004MM01";"     497";"     249";"     248";"   10260";"    4858";"    5402";"   10260";"   10079";"   10079";"     181";"       0";"       0";"       0";"       0";"       0"
"1904";"A043595";"2004MM02";"     491";"     245";"     246";"    9310";"    4729";"    4581";"    9310";"    9310";"    8840";"       0";"       0";"       0";"       0";"       0";"       0"
"1905";"A043595";"2004MM03";"     538";"     274";"     264";"    9979";"    4991";"    4988";"    9979";"    9979";"    8641";"       0";"       0";"       0";"       0";"       0";"       0"
"1906";"A043595";"2004KW01";"    1526";"     768";"     758";"   29549";"   14578";"   14971";"   29549";"   29368";"   27560";"     181";"       0";"       0";"       0";"       0";"       0"
"1907";"A043595";"2004MM04";"     511";"     258";"     253";"   13851";"    5636";"    8215";"   13851";"   13851";"    9198";"       0";"       0";"       0";"       0";"       0";"       0"
"1908";"A043595";"2004MM05";"     665";"     330";"     335";"   28888";"   14657";"   14231";"   28888";"   28888";"   18118";"       0";"       0";"       0";"       0";"       0";"       0"
"1909";"A043595";"2004MM06";"     688";"     347";"     341";"   29882";"   15495";"   14387";"   29882";"   29882";"   18823";"       0";"       0";"       0";"       0";"       0";"       0"
"1910";"A043595";"2004KW02";"    1864";"     935";"     929";"   72621";"   35788";"   36833";"   72621";"   72621";"   46139";"       0";"       0";"       0";"       0";"       0";"       0"
"1911";"A043595";"2004MM07";"     636";"     317";"     319";"   23619";"   10800";"   12819";"   23619";"   23619";"   15768";"       0";"       0";"       0";"       0";"       0";"       0"
"1912";"A043595";"2004MM08";"     626";"     320";"     306";"   29598";"   15232";"   14366";"   29598";"   29596";"   17350";"       2";"       2";"       0";"       0";"       0";"       0"
"1913";"A043595";"2004MM09";"     614";"     309";"     305";"   27625";"   13652";"   13973";"   27625";"   27623";"   18086";"       2";"       0";"       2";"       2";"       0";"       0"
"1914";"A043595";"2004KW03";"    1876";"     946";"     930";"   80842";"   39684";"   41158";"   80842";"   80838";"   51204";"       4";"       2";"       2";"       2";"       0";"       0"
"1915";"A043595";"2004MM10";"     640";"     321";"     319";"   23528";"   13727";"    9801";"   23528";"   23452";"   13983";"      76";"       0";"       0";"       0";"       0";"       0"
"1916";"A043595";"2004MM11";"     562";"     281";"     281";"   11314";"    6106";"    5208";"   11314";"   10260";"    8494";"    1054";"       0";"       0";"       0";"       0";"       0"
"1917";"A043595";"2004MM12";"     587";"     314";"     273";"   10464";"    5399";"    5065";"   10464";"    8983";"    7735";"    1300";"       0";"       0";"       0";"       0";"       0"
"1918";"A043595";"2004KW04";"    1789";"     916";"     873";"   45306";"   25232";"   20074";"   45306";"   42695";"   30212";"    2430";"       0";"       0";"       0";"       0";"       0"
"1919";"A043595";"2004JJ00";"    7055";"    3565";"    3490";"  228318";"  115282";"  113036";"  228318";"  225522";"  155115";"    2615";"       2";"       2";"       2";"       0";"       0"
"1920";"A043595";"2005MM01";"     494";"     248";"     246";"    7767";"    4145";"    3622";"    7767";"    6422";"    5665";"    1345";"       0";"       0";"       0";"       0";"       0"
"1921";"A043595";"2005MM02";"     444";"     221";"     223";"    7983";"    3941";"    4042";"    7983";"    6646";"    6455";"    1337";"       0";"       0";"       0";"       0";"       0"
"1922";"A043595";"2005MM03";"     466";"     234";"     232";"    8885";"    4607";"    4278";"    8885";"    7274";"    6991";"    1611";"       0";"       0";"       0";"       0";"       0"
"1923";"A043595";"2005KW01";"    1404";"     703";"     701";"   24635";"   12693";"   11942";"   24635";"   20342";"   19111";"    4293";"       0";"       0";"       0";"       0";"       0"
"1924";"A043595";"2005MM04";"     593";"     295";"     298";"   19231";"    8032";"   11199";"   19231";"   18975";"   12500";"     256";"       0";"       0";"       0";"       0";"       0"
"1925";"A043595";"2005MM05";"     773";"     383";"     390";"   44572";"   22005";"   22567";"   44572";"   44389";"   25360";"     183";"       0";"       0";"       0";"       0";"       0"
"1926";"A043595";"2005MM06";"     734";"     365";"     369";"   35524";"   18117";"   17407";"   35524";"   35274";"   25599";"     250";"       0";"     250";"     250";"       0";"       0"
"1927";"A043595";"2005KW02";"    2100";"    1043";"    1057";"   99327";"   48154";"   51173";"   99327";"   98638";"   63459";"     689";"       0";"     250";"     250";"       0";"       0"
"1928";"A043595";"2005MM07";"     673";"     336";"     337";"   39695";"   18191";"   21504";"   39695";"   39695";"   25507";"       0";"       0";"       0";"       0";"       0";"       0"
"1929";"A043595";"2005MM08";"     684";"     337";"     347";"   38645";"   20778";"   17867";"   38645";"   38645";"   24450";"       0";"       0";"       0";"       0";"       0";"       0"
"1930";"A043595";"2005MM09";"     761";"     382";"     379";"   38700";"   18966";"   19734";"   38700";"   38699";"   28191";"       0";"       0";"       0";"       0";"       0";"       0"
"1931";"A043595";"2005KW03";"    2118";"    1055";"    1063";"  117040";"   57935";"   59105";"  117040";"  117039";"   78148";"       0";"       0";"       0";"       0";"       0";"       0"
"1932";"A043595";"2005MM10";"     747";"     371";"     376";"   36017";"   19402";"   16615";"   36017";"   35433";"   19331";"     584";"       0";"       0";"       0";"       0";"       0"
"1933";"A043595";"2005MM11";"     530";"     264";"     266";"   18133";"    9773";"    8360";"   18133";"   18130";"   14867";"       3";"       0";"       0";"       0";"       0";"       0"
"1934";"A043595";"2005MM12";"     293";"     146";"     147";"    9039";"    4647";"    4392";"    9039";"    9039";"    8182";"       0";"       0";"       0";"       0";"       0";"       0"
"1935";"A043595";"2005KW04";"    1570";"     781";"     789";"   63189";"   33822";"   29367";"   63189";"   62602";"   42380";"     587";"       0";"       0";"       0";"       0";"       0"
"1936";"A043595";"2005JJ00";"    7192";"    3582";"    3610";"  304191";"  152604";"  151587";"  304191";"  298621";"  203098";"    5569";"       0";"     250";"     250";"       0";"       0"
"1937";"A043595";"2006MM01";"     904";"     454";"     450";"   14606";"    7586";"    7020";"   14606";"   14574";"   13125";"      32";"       0";"      32";"      32";"       0";"       0"
"1938";"A043595";"2006MM02";"     796";"     396";"     400";"   14578";"    7191";"    7387";"   14578";"   14575";"   13262";"       3";"       0";"       3";"       3";"       0";"       0"
"1939";"A043595";"2006MM03";"     973";"     485";"     488";"   19964";"   10093";"    9871";"   19964";"   19963";"   18120";"       1";"       0";"       1";"       1";"       0";"       0"
"1940";"A043595";"2006KW01";"    2673";"    1335";"    1338";"   49148";"   24870";"   24278";"   49148";"   49112";"   44507";"      36";"       0";"      36";"      36";"       0";"       0"
"1941";"A043595";"2006MM04";"    1003";"     504";"     499";"   23640";"   11071";"   12569";"   23640";"   23630";"   17754";"       7";"       4";"       3";"       3";"       0";"       0"
"1942";"A043595";"2006MM05";"    1201";"     597";"     604";"   31133";"   15034";"   16099";"   31133";"   30876";"   22474";"     222";"       0";"       7";"       7";"       0";"       0"
"1943";"A043595";"2006MM06";"    1149";"     572";"     577";"   29044";"   14258";"   14786";"   29044";"   28562";"   21505";"     482";"       0";"       0";"       0";"       0";"       0"
"1944";"A043595";"2006KW02";"    3353";"    1673";"    1680";"   83817";"   40363";"   43454";"   83817";"   83068";"   61733";"     711";"       4";"      10";"      10";"       0";"       0"
"1945";"A043595";"2006MM07";"    1218";"     606";"     612";"   33814";"   16018";"   17796";"   33814";"   33686";"   22602";"     127";"      92";"       0";"       0";"       0";"       0"
"1946";"A043595";"2006MM08";"    1240";"     621";"     619";"   29995";"   16314";"   13681";"   29995";"   29985";"   20524";"       8";"       4";"       2";"       0";"       2";"       0"
"1947";"A043595";"2006MM09";"    1098";"     545";"     553";"   27698";"   13638";"   14060";"   27698";"   27696";"   22376";"       2";"       2";"       0";"       0";"       0";"       0"
"1948";"A043595";"2006KW03";"    3556";"    1772";"    1784";"   91507";"   45970";"   45537";"   91507";"   91367";"   65502";"     137";"      98";"       2";"       0";"       2";"       0"
"1949";"A043595";"2006MM10";"    1067";"     536";"     531";"   21703";"   11554";"   10149";"   21703";"   21701";"   15761";"       0";"       0";"       0";"       0";"       0";"       0"
"1950";"A043595";"2006MM11";"     889";"     447";"     442";"   12853";"    6587";"    6266";"   12853";"   12851";"   12681";"       2";"       0";"       0";"       0";"       0";"       0"
"1951";"A043595";"2006MM12";"     762";"     383";"     379";"   11058";"    5394";"    5664";"   11058";"   11058";"   11054";"       0";"       0";"       0";"       0";"       0";"       0"
"1952";"A043595";"2006KW04";"    2718";"    1366";"    1352";"   45614";"   23535";"   22079";"   45614";"   45610";"   39496";"       2";"       0";"       0";"       0";"       0";"       0"
"1953";"A043595";"2006JJ00";"   12300";"    6146";"    6154";"  270086";"  134738";"  135348";"  270086";"  269157";"  211238";"     886";"     102";"      48";"      46";"       2";"       0"
"1954";"A043595";"2007MM01";"     676";"     336";"     340";"    5268";"    2641";"    2627";"    5268";"    5264";"    5089";"       4";"       0";"       0";"       0";"       0";"       0"
"1955";"A043595";"2007MM02";"     699";"     349";"     350";"    5115";"    2624";"    2491";"    5115";"    5115";"    5057";"       0";"       0";"       0";"       0";"       0";"       0"
"1956";"A043595";"2007MM03";"     808";"     402";"     406";"    6971";"    3369";"    3602";"    6971";"    6971";"    6927";"       0";"       0";"       0";"       0";"       0";"       0"
"1957";"A043595";"2007KW01";"    2183";"    1087";"    1096";"   17354";"    8634";"    8720";"   17354";"   17350";"   17073";"       4";"       0";"       0";"       0";"       0";"       0"
"1958";"A043595";"2007MM04";"     775";"     393";"     382";"    5958";"    2865";"    3093";"    5958";"    5957";"    5951";"       1";"       1";"       0";"       0";"       0";"       0"
"1959";"A043595";"2007MM05";"     946";"     473";"     473";"   10417";"    4993";"    5424";"   10417";"   10417";"   10417";"       0";"       0";"       0";"       0";"       0";"       0"
"1960";"A043595";"2007MM06";"     995";"     493";"     502";"   14702";"    6795";"    7907";"   14702";"   14701";"   14697";"       0";"       0";"       0";"       0";"       0";"       0"
"1961";"A043595";"2007KW02";"    2716";"    1359";"    1357";"   31077";"   14653";"   16424";"   31077";"   31075";"   31065";"       1";"       1";"       0";"       0";"       0";"       0"
"1962";"A043595";"2007MM07";"     954";"     479";"     475";"   15419";"    7019";"    8400";"   15419";"   15413";"   13969";"       0";"       0";"       0";"       0";"       0";"       0"
"1963";"A043595";"2007MM08";"     896";"     448";"     448";"   15069";"    8516";"    6553";"   15069";"   15067";"   13035";"       0";"       0";"       0";"       0";"       0";"       0"
"1964";"A043595";"2007MM09";"     814";"     407";"     407";"   15095";"    7419";"    7676";"   15095";"   15089";"   15035";"       6";"       0";"       0";"       0";"       0";"       0"
"1965";"A043595";"2007KW03";"    2664";"    1334";"    1330";"   45583";"   22954";"   22629";"   45583";"   45569";"   42039";"       6";"       0";"       0";"       0";"       0";"       0"
"1966";"A043595";"2007MM10";"     750";"     373";"     377";"   11153";"    5690";"    5463";"   11153";"   11153";"   11152";"       0";"       0";"       0";"       0";"       0";"       0"
"1967";"A043595";"2007MM11";"     857";"     427";"     430";"   14774";"    7416";"    7358";"   14774";"   14767";"   14762";"       0";"       0";"       0";"       0";"       0";"       0"
"1968";"A043595";"2007MM12";"     773";"     384";"     389";"   14638";"    7066";"    7572";"   14638";"   14406";"   14406";"     232";"       0";"       0";"       0";"       0";"       0"
"1969";"A043595";"2007KW04";"    2380";"    1184";"    1196";"   40565";"   20172";"   20393";"   40565";"   40326";"   40320";"     232";"       0";"       0";"       0";"       0";"       0"
"1970";"A043595";"2007JJ00";"    9943";"    4964";"    4979";"  134579";"   66413";"   68166";"  134579";"  134320";"  130497";"     243";"       1";"       0";"       0";"       0";"       0"
"1971";"A043595";"2008MM01";"     827";"     412";"     415";"   13529";"    6581";"    6948";"   13529";"   13454";"   13454";"      73";"       0";"       0";"       0";"       0";"       0"
"1972";"A043595";"2008MM02";"     794";"     399";"     395";"   15611";"    7674";"    7937";"   15611";"   15465";"   15325";"     140";"       0";"     140";"       0";"     140";"       0"
"1973";"A043595";"2008MM03";"     863";"     430";"     433";"   17906";"    8623";"    9283";"   17906";"   17906";"   17906";"       0";"       0";"       0";"       0";"       0";"       0"
"1974";"A043595";"2008KW01";"    2484";"    1241";"    1243";"   47046";"   22878";"   24168";"   47046";"   46825";"   46685";"     213";"       0";"     140";"       0";"     140";"       0"
"1975";"A043595";"2008MM04";"     890";"     443";"     447";"   19662";"    9150";"   10512";"   19662";"   19660";"   18958";"       2";"       0";"       0";"       0";"       0";"       0"
"1976";"A043595";"2008MM05";"    1087";"     540";"     547";"   24653";"   12166";"   12487";"   24653";"   24653";"   22404";"       0";"       0";"       0";"       0";"       0";"       0"
"1977";"A043595";"2008MM06";"    1066";"     535";"     531";"   23184";"   11246";"   11938";"   23184";"   23176";"   21836";"       8";"       0";"       8";"       8";"       0";"       0"
"1978";"A043595";"2008KW02";"    3043";"    1518";"    1525";"   67499";"   32562";"   34937";"   67499";"   67489";"   63198";"      10";"       0";"       8";"       8";"       0";"       0"
"1979";"A043595";"2008MM07";"    1177";"     588";"     589";"   25643";"   11734";"   13909";"   25643";"   25643";"   23344";"       0";"       0";"       0";"       0";"       0";"       0"
"1980";"A043595";"2008MM08";"    1097";"     547";"     550";"   25284";"   13739";"   11545";"   25284";"   25284";"   23144";"       0";"       0";"       0";"       0";"       0";"       0"
"1981";"A043595";"2008MM09";"    1128";"     563";"     565";"   25293";"   12416";"   12877";"   25293";"   25071";"   23317";"     222";"       0";"     222";"       1";"     221";"       0"
"1982";"A043595";"2008KW03";"    3402";"    1698";"    1704";"   76220";"   37889";"   38331";"   76220";"   75998";"   69805";"     222";"       0";"     222";"       1";"     221";"       0"
"1983";"A043595";"2008MM10";"     992";"     498";"     494";"   22152";"   11948";"   10204";"   22152";"   21977";"   20030";"     175";"       0";"     173";"     173";"       0";"       0"
"1984";"A043595";"2008MM11";"     544";"     273";"     271";"   10645";"    5971";"    4674";"   10645";"   10645";"   10353";"       0";"       0";"       0";"       0";"       0";"       0"
"1985";"A043595";"2008MM12";"     430";"     213";"     217";"    8262";"    4118";"    4144";"    8262";"    8262";"    7895";"       0";"       0";"       0";"       0";"       0";"       0"
"1986";"A043595";"2008KW04";"    1966";"     984";"     982";"   41059";"   22037";"   19022";"   41059";"   40884";"   38278";"     175";"       0";"     173";"     173";"       0";"       0"
"1987";"A043595";"2008JJ00";"   10895";"    5441";"    5454";"  231824";"  115366";"  116458";"  231824";"  231196";"  217966";"     620";"       0";"     543";"     182";"     361";"       0"
"1988";"A043595";"2009MM01";"     418";"     207";"     211";"    4060";"    2441";"    1619";"    4060";"    4056";"    3022";"       4";"       0";"       0";"       0";"       0";"       0"
"1989";"A043595";"2009MM02";"     396";"     199";"     197";"    1567";"     800";"     767";"    1567";"    1567";"     848";"       0";"       0";"       0";"       0";"       0";"       0"
"1990";"A043595";"2009MM03";"     438";"     219";"     219";"    1401";"     628";"     773";"    1401";"    1401";"    1400";"       0";"       0";"       0";"       0";"       0";"       0"
"1991";"A043595";"2009KW01";"    1252";"     625";"     627";"    7028";"    3869";"    3159";"    7028";"    7024";"    5270";"       4";"       0";"       0";"       0";"       0";"       0"
"1992";"A043595";"2009MM04";"     592";"     296";"     296";"   12373";"    5538";"    6835";"   12373";"   12373";"   11707";"       0";"       0";"       0";"       0";"       0";"       0"
"1993";"A043595";"2009MM05";"     709";"     355";"     354";"   16456";"    8459";"    7997";"   16456";"   16456";"   15067";"       0";"       0";"       0";"       0";"       0";"       0"
"1994";"A043595";"2009MM06";"     695";"     349";"     346";"   16085";"    7968";"    8117";"   16085";"   16085";"   14624";"       0";"       0";"       0";"       0";"       0";"       0"
"1995";"A043595";"2009KW02";"    1996";"    1000";"     996";"   44914";"   21965";"   22949";"   44914";"   44914";"   41398";"       0";"       0";"       0";"       0";"       0";"       0"
"1996";"A043595";"2009MM07";"     737";"     368";"     369";"   18771";"    8305";"   10466";"   18771";"   18550";"   16018";"     221";"       0";"     221";"       0";"     221";"       0"
"1997";"A043595";"2009MM08";"     731";"     363";"     368";"   21332";"   11511";"    9821";"   21332";"   21332";"   18908";"       0";"       0";"       0";"       0";"       0";"       0"
"1998";"A043595";"2009MM09";"     731";"     367";"     364";"   17157";"    8721";"    8436";"   17157";"   17153";"   15470";"       4";"       0";"       0";"       0";"       0";"       0"
"1999";"A043595";"2009KW03";"    2199";"    1098";"    1101";"   57260";"   28537";"   28723";"   57260";"   57035";"   50396";"     225";"       0";"     221";"       0";"     221";"       0"
"2000";"A043595";"2009MM10";"     665";"     332";"     333";"   14304";"    7713";"    6591";"   14304";"   14296";"   12564";"       8";"       0";"       0";"       0";"       0";"       0"
"2001";"A043595";"2009MM11";"     525";"     264";"     261";"    5425";"    2873";"    2552";"    5425";"    5425";"    5423";"       0";"       0";"       0";"       0";"       0";"       0"
"2002";"A043595";"2009MM12";"     522";"     258";"     264";"    6765";"    3463";"    3302";"    6765";"    6765";"    6765";"       0";"       0";"       0";"       0";"       0";"       0"
"2003";"A043595";"2009KW04";"    1712";"     854";"     858";"   26494";"   14049";"   12445";"   26494";"   26486";"   24752";"       8";"       0";"       0";"       0";"       0";"       0"
"2004";"A043595";"2009JJ00";"    7159";"    3577";"    3582";"  135696";"   68420";"   67276";"  135696";"  135459";"  121816";"     237";"       0";"     221";"       0";"     221";"       0"
"2005";"A043595";"2010MM01";"     528";"     267";"     261";"    5285";"    2652";"    2633";"    5285";"    5285";"    5285";"       0";"       0";"       0";"       0";"       0";"       0"
"2006";"A043595";"2010MM02";"     505";"     256";"     249";"    5391";"    2700";"    2691";"    5391";"    5391";"    5323";"       0";"       0";"       0";"       0";"       0";"       0"
"2007";"A043595";"2010MM03";"     562";"     283";"     279";"    7807";"    3611";"    4196";"    7807";"    7803";"    7801";"       2";"       0";"       2";"       0";"       0";"       2"
"2008";"A043595";"2010KW01";"    1595";"     806";"     789";"   18483";"    8963";"    9520";"   18483";"   18479";"   18409";"       2";"       0";"       2";"       0";"       0";"       2"
"2009";"A043595";"2010MM04";"     503";"     251";"     252";"   11353";"    5067";"    6286";"   11353";"   11349";"    9713";"       4";"       0";"       0";"       0";"       0";"       0"
"2010";"A043595";"2010MM05";"     788";"     398";"     390";"   22578";"   11452";"   11126";"   22578";"   21777";"   19708";"     801";"     801";"       0";"       0";"       0";"       0"
"2011";"A043595";"2010MM06";"     836";"     417";"     419";"   25498";"   12313";"   13185";"   25498";"   25498";"   23737";"       0";"       0";"       0";"       0";"       0";"       0"
"2012";"A043595";"2010KW02";"    2127";"    1066";"    1061";"   59429";"   28832";"   30597";"   59429";"   58624";"   53158";"     805";"     801";"       0";"       0";"       0";"       0"
"2013";"A043595";"2010MM07";"     881";"     443";"     438";"   34321";"   14684";"   19637";"   34321";"   34321";"   32091";"       0";"       0";"       0";"       0";"       0";"       0"
"2014";"A043595";"2010MM08";"     952";"     478";"     474";"   35917";"   20157";"   15760";"   35917";"   35917";"   33574";"       0";"       0";"       0";"       0";"       0";"       0"
"2015";"A043595";"2010MM09";"     902";"     452";"     450";"   32011";"   16829";"   15182";"   32011";"   31064";"   28883";"     947";"     496";"       0";"       0";"       0";"       0"
"2016";"A043595";"2010KW03";"    2735";"    1373";"    1362";"  102249";"   51670";"   50579";"  102249";"  101302";"   94548";"     947";"     496";"       0";"       0";"       0";"       0"
"2017";"A043595";"2010MM10";"     867";"     433";"     434";"   29690";"   15391";"   14299";"   29690";"   29686";"   27761";"       4";"       0";"       2";"       2";"       0";"       0"
"2018";"A043595";"2010MM11";"     570";"     283";"     287";"    9150";"    4937";"    4213";"    9150";"    9148";"    9079";"       2";"       0";"       0";"       0";"       0";"       0"
"2019";"A043595";"2010MM12";"     549";"     278";"     271";"    7634";"    3539";"    4095";"    7634";"    7633";"    7629";"       1";"       1";"       0";"       0";"       0";"       0"
"2020";"A043595";"2010KW04";"    1986";"     994";"     992";"   46474";"   23867";"   22607";"   46474";"   46467";"   44469";"       7";"       1";"       2";"       2";"       0";"       0"
"2021";"A043595";"2010JJ00";"    8443";"    4239";"    4204";"  226635";"  113332";"  113303";"  226635";"  224872";"  210584";"    1761";"    1298";"       4";"       2";"       0";"       2"
"2022";"A043595";"2011MM01";"     288";"     144";"     144";"    7774";"    4092";"    3682";"    7774";"    7770";"    7770";"       0";"       0";"       0";"       0";"       0";"       0"
"2023";"A043595";"2011MM02";"     299";"     148";"     151";"    8464";"    3862";"    4602";"    8464";"    8463";"    8461";"       1";"       0";"       0";"       0";"       0";"       0"
"2024";"A043595";"2011MM03";"     406";"     202";"     204";"   17592";"    8513";"    9079";"   17592";"   17590";"   17584";"       0";"       0";"       0";"       0";"       0";"       0"
"2025";"A043595";"2011KW01";"     993";"     494";"     499";"   33830";"   16467";"   17363";"   33830";"   33823";"   33815";"       1";"       0";"       0";"       0";"       0";"       0"
"2026";"A043595";"2011MM04";"     550";"     276";"     274";"   36048";"   16589";"   19459";"   36048";"   36048";"   35366";"       0";"       0";"       0";"       0";"       0";"       0"
"2027";"A043595";"2011MM05";"     609";"     305";"     304";"   40370";"   20321";"   20049";"   40370";"   40370";"   37943";"       0";"       0";"       0";"       0";"       0";"       0"
"2028";"A043595";"2011MM06";"     629";"     313";"     316";"   40209";"   19521";"   20688";"   40209";"   40040";"   38599";"     169";"       0";"       0";"       0";"       0";"       0"
"2029";"A043595";"2011KW02";"    1788";"     894";"     894";"  116627";"   56431";"   60196";"  116627";"  116458";"  111908";"     169";"       0";"       0";"       0";"       0";"       0"
"2030";"A043595";"2011MM07";"     576";"     289";"     287";"   44085";"   19547";"   24538";"   44085";"   43713";"   41653";"     372";"       0";"       0";"       0";"       0";"       0"
"2031";"A043595";"2011MM08";"     596";"     298";"     298";"   46920";"   24921";"   21999";"   46920";"   46705";"   44305";"     189";"       2";"     187";"     187";"       0";"       0"
"2032";"A043595";"2011MM09";"     580";"     292";"     288";"   41470";"   20997";"   20473";"   41470";"   41470";"   39688";"       0";"       0";"       0";"       0";"       0";"       0"
"2033";"A043595";"2011KW03";"    1752";"     879";"     873";"  132475";"   65465";"   67010";"  132475";"  131888";"  125646";"     561";"       2";"     187";"     187";"       0";"       0"
"2034";"A043595";"2011MM10";"     562";"     284";"     278";"   38851";"   19784";"   19067";"   38851";"   38851";"   36881";"       0";"       0";"       0";"       0";"       0";"       0"
"2035";"A043595";"2011MM11";"     329";"     167";"     162";"    6751";"    3822";"    2929";"    6751";"    6528";"    6131";"     223";"     223";"       0";"       0";"       0";"       0"
"2036";"A043595";"2011MM12";"     346";"     170";"     176";"    5376";"    2266";"    3110";"    5376";"    4873";"    4873";"     501";"       0";"     146";"     146";"       0";"       0"
"2037";"A043595";"2011KW04";"    1237";"     621";"     616";"   50978";"   25872";"   25106";"   50978";"   50252";"   47885";"     724";"     223";"     146";"     146";"       0";"       0"
"2038";"A043595";"2011JJ00";"    5770";"    2888";"    2882";"  333910";"  164235";"  169675";"  333910";"  332421";"  319254";"    1455";"     225";"     333";"     333";"       0";"       0"
"2039";"A043595";"2012MM01";"     308";"     154";"     154";"    4909";"    2684";"    2225";"    4909";"    4308";"    4131";"     601";"     474";"     127";"     127";"       0";"       0"
"2040";"A043595";"2012MM02";"     336";"     169";"     167";"    4223";"    1970";"    2253";"    4223";"    4221";"    4217";"       0";"       0";"       0";"       0";"       0";"       0"
"2041";"A043595";"2012MM03";"     372";"     186";"     186";"    9478";"    3710";"    5768";"    9478";"    9472";"    9472";"       6";"       6";"       0";"       0";"       0";"       0"
"2042";"A043595";"2012KW01";"    1016";"     509";"     507";"   18610";"    8364";"   10246";"   18610";"   18001";"   17820";"     607";"     480";"     127";"     127";"       0";"       0"
"2043";"A043595";"2012MM04";"     473";"     239";"     234";"   31828";"   15067";"   16761";"   31828";"   31824";"   31597";"       2";"       2";"       0";"       0";"       0";"       0"
"2044";"A043595";"2012MM05";"     566";"     278";"     288";"   36673";"   18101";"   18572";"   36673";"   36671";"   35354";"       0";"       0";"       0";"       0";"       0";"       0"
"2045";"A043595";"2012MM06";"     518";"     262";"     256";"   33476";"   15955";"   17521";"   33476";"   33476";"   32418";"       0";"       0";"       0";"       0";"       0";"       0"
"2046";"A043595";"2012KW02";"    1557";"     779";"     778";"  101977";"   49123";"   52854";"  101977";"  101971";"   99369";"       2";"       2";"       0";"       0";"       0";"       0"
"2047";"A043595";"2012MM07";"     545";"     273";"     272";"   46797";"   20465";"   26332";"   46797";"   46792";"   45295";"       1";"       0";"       1";"       1";"       0";"       0"
"2048";"A043595";"2012MM08";"     543";"     271";"     272";"   45125";"   25213";"   19912";"   45125";"   45117";"   43987";"       3";"       0";"       3";"       3";"       0";"       0"
"2049";"A043595";"2012MM09";"     513";"     256";"     257";"   36458";"   18666";"   17792";"   36458";"   36454";"   35399";"       3";"       0";"       3";"       3";"       0";"       0"
"2050";"A043595";"2012KW03";"    1601";"     800";"     801";"  128380";"   64344";"   64036";"  128380";"  128363";"  124681";"       7";"       0";"       7";"       7";"       0";"       0"
"2051";"A043595";"2012MM10";"     512";"     258";"     254";"   31208";"   16248";"   14960";"   31208";"   31204";"   30251";"       4";"       0";"       4";"       4";"       0";"       0"
"2052";"A043595";"2012MM11";"     355";"     178";"     177";"    8555";"    4620";"    3935";"    8555";"    8555";"    8452";"       0";"       0";"       0";"       0";"       0";"       0"
"2053";"A043595";"2012MM12";"     404";"     204";"     200";"   16709";"    8012";"    8697";"   16709";"   16707";"   16557";"       1";"       0";"       1";"       1";"       0";"       0"
"2054";"A043595";"2012KW04";"    1271";"     640";"     631";"   56472";"   28880";"   27592";"   56472";"   56466";"   55260";"       5";"       0";"       5";"       5";"       0";"       0"
"2055";"A043595";"2012JJ00";"    5445";"    2728";"    2717";"  305439";"  150711";"  154728";"  305439";"  304801";"  297130";"     621";"     482";"     139";"     139";"       0";"       0"
"2056";"A043595";"2013MM01";"     414";"     207";"     207";"   16087";"    8270";"    7817";"   16087";"   16086";"   15836";"       0";"       0";"       0";"       0";"       0";"       0"
"2057";"A043595";"2013MM02";"     401";"     204";"     197";"   16421";"    8036";"    8385";"   16421";"   16417";"   16417";"       0";"       0";"       0";"       0";"       0";"       0"
"2058";"A043595";"2013MM03";"     479";"     235";"     244";"   21892";"   10118";"   11774";"   21892";"   21892";"   21890";"       0";"       0";"       0";"       0";"       0";"       0"
"2059";"A043595";"2013KW01";"    1294";"     646";"     648";"   54400";"   26424";"   27976";"   54400";"   54395";"   54143";"       0";"       0";"       0";"       0";"       0";"       0"
"2060";"A043595";"2013MM04";"     580";"     291";"     289";"   43092";"   20780";"   22312";"   43092";"   43091";"   42254";"       1";"       0";"       1";"       1";"       0";"       0"
"2061";"A043595";"2013MM05";"     613";"     307";"     306";"   47093";"   23689";"   23404";"   47093";"   47093";"   44485";"       0";"       0";"       0";"       0";"       0";"       0"
"2062";"A043595";"2013MM06";"     607";"     304";"     303";"   41080";"   20095";"   20985";"   41080";"   41075";"   38896";"       5";"       0";"       5";"       5";"       0";"       0"
"2063";"A043595";"2013KW02";"    1800";"     902";"     898";"  131265";"   64564";"   66701";"  131265";"  131259";"  125635";"       6";"       0";"       6";"       6";"       0";"       0"
"2064";"A043595";"2013MM07";"     656";"     327";"     329";"   57650";"   25600";"   32050";"   57650";"   57637";"   54128";"      13";"       0";"       0";"       0";"       0";"       0"
"2065";"A043595";"2013MM08";"     626";"     310";"     316";"   58868";"   31965";"   26903";"   58868";"   58864";"   56565";"       0";"       0";"       0";"       0";"       0";"       0"
"2066";"A043595";"2013MM09";"     590";"     293";"     297";"   44163";"   23100";"   21063";"   44163";"   44163";"   41812";"       0";"       0";"       0";"       0";"       0";"       0"
"2067";"A043595";"2013KW03";"    1872";"     930";"     942";"  160681";"   80665";"   80016";"  160681";"  160664";"  152505";"      13";"       0";"       0";"       0";"       0";"       0"
"2068";"A043595";"2013MM10";"     613";"     310";"     303";"   48287";"   24950";"   23337";"   48287";"   48285";"   45351";"       0";"       0";"       0";"       0";"       0";"       0"
"2069";"A043595";"2013MM11";"     408";"     206";"     202";"   17727";"    9826";"    7901";"   17727";"   17727";"   17725";"       0";"       0";"       0";"       0";"       0";"       0"
"2070";"A043595";"2013MM12";"     353";"     174";"     179";"   17185";"    8122";"    9063";"   17185";"   17184";"   17086";"       1";"       0";"       1";"       1";"       0";"       0"
"2071";"A043595";"2013KW04";"    1374";"     690";"     684";"   83199";"   42898";"   40301";"   83199";"   83196";"   80162";"       1";"       0";"       1";"       1";"       0";"       0"
"2072";"A043595";"2013JJ00";"    6340";"    3168";"    3172";"  429545";"  214551";"  214994";"  429545";"  429514";"  412445";"      20";"       0";"       7";"       7";"       0";"       0"
"2073";"A043595";"2014MM01";"     340";"     169";"     171";"   11130";"    5832";"    5298";"   11130";"   11130";"   11130";"       0";"       0";"       0";"       0";"       0";"       0"
"2074";"A043595";"2014MM02";"     348";"     173";"     175";"   11187";"    5312";"    5875";"   11187";"   11184";"   11180";"       0";"       0";"       0";"       0";"       0";"       0"
"2075";"A043595";"2014MM03";"     402";"     197";"     205";"   13284";"    6904";"    6380";"   13284";"   13284";"   13282";"       0";"       0";"       0";"       0";"       0";"       0"
"2076";"A043595";"2014KW01";"    1090";"     539";"     551";"   35601";"   18048";"   17553";"   35601";"   35598";"   35592";"       0";"       0";"       0";"       0";"       0";"       0"
"2077";"A043595";"2014MM04";"     408";"     203";"     205";"   23343";"   10438";"   12905";"   23343";"   23343";"   22968";"       0";"       0";"       0";"       0";"       0";"       0"
"2078";"A043595";"2014MM05";"     456";"     229";"     227";"   25966";"   13016";"   12950";"   25966";"   25965";"   24150";"       1";"       0";"       1";"       1";"       0";"       0"
"2079";"A043595";"2014MM06";"     461";"     232";"     229";"   23303";"   11296";"   12007";"   23303";"   23283";"   21455";"      20";"       0";"       1";"       1";"       0";"       0"
"2080";"A043595";"2014KW02";"    1325";"     664";"     661";"   72612";"   34750";"   37862";"   72612";"   72591";"   68573";"      21";"       0";"       2";"       2";"       0";"       0"
"2081";"A043595";"2014MM07";"     514";"     256";"     258";"   28814";"   12446";"   16368";"   28814";"   28799";"   27139";"      14";"      12";"       0";"       0";"       0";"       0"
"2082";"A043595";"2014MM08";"     492";"     246";"     246";"   32593";"   17682";"   14911";"   32593";"   31256";"   29101";"    1334";"       0";"       1";"       1";"       0";"       0"
"2083";"A043595";"2014MM09";"     485";"     243";"     242";"   28138";"   14566";"   13572";"   28138";"   28000";"   26283";"     138";"       0";"       0";"       0";"       0";"       0"
"2084";"A043595";"2014KW03";"    1491";"     745";"     746";"   89545";"   44694";"   44851";"   89545";"   88055";"   82523";"    1486";"      12";"       1";"       1";"       0";"       0"
"2085";"A043595";"2014MM10";"     486";"     244";"     242";"   26408";"   13740";"   12668";"   26408";"   26391";"   24466";"      17";"       0";"       9";"       9";"       0";"       0"
"2086";"A043595";"2014MM11";"     336";"     165";"     171";"    8320";"    4587";"    3733";"    8320";"    8315";"    8312";"       5";"       3";"       2";"       2";"       0";"       0"
"2087";"A043595";"2014MM12";"     298";"     150";"     148";"    8987";"    4412";"    4575";"    8987";"    8489";"    8485";"     498";"       0";"       0";"       0";"       0";"       0"
"2088";"A043595";"2014KW04";"    1120";"     559";"     561";"   43715";"   22739";"   20976";"   43715";"   43195";"   41263";"     520";"       3";"      11";"      11";"       0";"       0"
"2089";"A043595";"2014JJ00";"    5026";"    2507";"    2519";"  241473";"  120231";"  121242";"  241473";"  239439";"  227951";"    2027";"      15";"      14";"      14";"       0";"       0"
"2090";"A043595";"2015MM01";"     268";"     135";"     133";"    6323";"    3282";"    3041";"    6323";"    6317";"    6313";"       6";"       3";"       3";"       3";"       0";"       0"
"2091";"A043595";"2015MM02";"     232";"     114";"     118";"    6309";"    2984";"    3325";"    6309";"    6230";"    6229";"      79";"      78";"       1";"       1";"       0";"       0"
"2092";"A043595";"2015MM03";"     265";"     129";"     136";"    7310";"    3439";"    3871";"    7310";"    7308";"    7306";"       2";"       0";"       0";"       0";"       0";"       0"
"2093";"A043595";"2015KW01";"     765";"     378";"     387";"   19942";"    9705";"   10237";"   19942";"   19855";"   19848";"      87";"      81";"       4";"       4";"       0";"       0"
"2094";"A043595";"2015MM04";"     327";"     163";"     164";"   17961";"    8365";"    9596";"   17961";"   17960";"   17500";"       1";"       0";"       1";"       1";"       0";"       0"
"2095";"A043595";"2015MM05";"     395";"     198";"     197";"   23331";"   11708";"   11623";"   23331";"   23329";"   21900";"       0";"       0";"       0";"       0";"       0";"       0"
"2096";"A043595";"2015MM06";"     394";"     196";"     198";"   23003";"   11399";"   11604";"   23003";"   23002";"   21371";"       0";"       0";"       0";"       0";"       0";"       0"
"2097";"A043595";"2015KW02";"    1116";"     557";"     559";"   64295";"   31472";"   32823";"   64295";"   64291";"   60771";"       1";"       0";"       1";"       1";"       0";"       0"
"2098";"A043595";"2015MM07";"     383";"     194";"     189";"   25580";"   11537";"   14043";"   25580";"   25579";"   24330";"       1";"       0";"       1";"       1";"       0";"       0"
"2099";"A043595";"2015MM08";"     410";"     204";"     206";"   26824";"   14301";"   12523";"   26824";"   26817";"   24876";"       4";"       0";"       4";"       2";"       2";"       0"
"2100";"A043595";"2015MM09";"     365";"     184";"     181";"   22278";"   11326";"   10952";"   22278";"   22276";"   21778";"       2";"       2";"       0";"       0";"       0";"       0"
"2101";"A043595";"2015KW03";"    1158";"     582";"     576";"   74682";"   37164";"   37518";"   74682";"   74672";"   70984";"       7";"       2";"       5";"       3";"       2";"       0"
"2102";"A043595";"2015MM10";"     401";"     201";"     200";"   22040";"   11493";"   10547";"   22040";"   22040";"   21370";"       0";"       0";"       0";"       0";"       0";"       0"
"2103";"A043595";"2015MM11";"     318";"     160";"     158";"    8562";"    4649";"    3913";"    8562";"    8562";"    8560";"       0";"       0";"       0";"       0";"       0";"       0"
"2104";"A043595";"2015MM12";"     307";"     153";"     154";"    5659";"    2686";"    2973";"    5659";"    5659";"    5653";"       0";"       0";"       0";"       0";"       0";"       0"
"2105";"A043595";"2015KW04";"    1026";"     514";"     512";"   36261";"   18828";"   17433";"   36261";"   36261";"   35583";"       0";"       0";"       0";"       0";"       0";"       0"
"2106";"A043595";"2015JJ00";"    4065";"    2031";"    2034";"  195180";"   97169";"   98011";"  195180";"  195079";"  187186";"      95";"      83";"      10";"       8";"       2";"       0"
"2107";"A043595";"2016MM01";"     294";"     149";"     145";"    4968";"    2485";"    2483";"    4968";"    4966";"    4966";"       0";"       0";"       0";"       0";"       0";"       0"
"2108";"A043595";"2016MM02";"     306";"     155";"     151";"    5891";"    2924";"    2967";"    5891";"    5891";"    5891";"       0";"       0";"       0";"       0";"       0";"       0"
"2109";"A043595";"2016MM03";"     386";"     194";"     192";"    8540";"    4193";"    4347";"    8540";"    8539";"    8290";"       0";"       0";"       0";"       0";"       0";"       0"
"2110";"A043595";"2016KW01";"     986";"     498";"     488";"   19399";"    9602";"    9797";"   19399";"   19396";"   19147";"       0";"       0";"       0";"       0";"       0";"       0"
"2111";"A043595";"2016MM04";"     367";"     186";"     181";"   17161";"    8542";"    8619";"   17161";"   17152";"   16944";"       9";"       9";"       0";"       0";"       0";"       0"
"2112";"A043595";"2016MM05";"     343";"     172";"     171";"   20207";"   10441";"    9766";"   20207";"   20207";"   18704";"       0";"       0";"       0";"       0";"       0";"       0"
"2113";"A043595";"2016MM06";"     500";"     250";"     250";"   42144";"   21002";"   21142";"   42144";"   42144";"   37801";"       0";"       0";"       0";"       0";"       0";"       0"
"2114";"A043595";"2016KW02";"    1210";"     608";"     602";"   79512";"   39985";"   39527";"   79512";"   79503";"   73449";"       9";"       9";"       0";"       0";"       0";"       0"
"2115";"A043595";"2016MM07";"     318";"     161";"     157";"   17441";"    8098";"    9343";"   17441";"   17427";"   17161";"       4";"       0";"       0";"       0";"       0";"       0"
"2116";"A043595";"2016MM08";"     283";"     145";"     138";"   18147";"    9620";"    8527";"   18147";"   18147";"   18147";"       0";"       0";"       0";"       0";"       0";"       0"
"2117";"A043595";"2016MM09";"     275";"     138";"     137";"   13600";"    6981";"    6619";"   13600";"   13585";"   13585";"       6";"       0";"       6";"       6";"       0";"       0"
"2118";"A043595";"2016KW03";"     876";"     444";"     432";"   49188";"   24699";"   24489";"   49188";"   49159";"   48893";"      10";"       0";"       6";"       6";"       0";"       0"
"2119";"A043595";"2016MM10";"     312";"     157";"     155";"   15100";"    8218";"    6882";"   15100";"   15098";"   15098";"       0";"       0";"       0";"       0";"       0";"       0"
"2120";"A043595";"2016MM11";"     280";"     141";"     139";"    6486";"    3494";"    2992";"    6486";"    6486";"    6484";"       0";"       0";"       0";"       0";"       0";"       0"
"2121";"A043595";"2016MM12";"     267";"     136";"     131";"    6877";"    3975";"    2902";"    6877";"    6877";"    6531";"       0";"       0";"       0";"       0";"       0";"       0"
"2122";"A043595";"2016KW04";"     859";"     434";"     425";"   28463";"   15687";"   12776";"   28463";"   28461";"   28113";"       0";"       0";"       0";"       0";"       0";"       0"
"2123";"A043595";"2016JJ00";"    3931";"    1984";"    1947";"  176562";"   89973";"   86589";"  176562";"  176519";"  169602";"      19";"       9";"       6";"       6";"       0";"       0"
"2124";"A043595";"2017MM01";"     229";"     113";"     116";"    6095";"    3265";"    2830";"    6095";"    6087";"    5917";"       0";"       0";"       0";"       0";"       0";"       0"
"2125";"A043595";"2017MM02";"     284";"     143";"     141";"    5562";"    2660";"    2902";"    5562";"    5560";"    5496";"       0";"       0";"       0";"       0";"       0";"       0"
"2126";"A043595";"2017MM03";"     328";"     168";"     160";"    6847";"    3163";"    3684";"    6847";"    6845";"    6843";"       0";"       0";"       0";"       0";"       0";"       0"
"2127";"A043595";"2017KW01";"     841";"     424";"     417";"   18504";"    9088";"    9416";"   18504";"   18492";"   18256";"       0";"       0";"       0";"       0";"       0";"       0"
"2128";"A043595";"2017MM04";"     341";"     165";"     176";"   15478";"    7366";"    8112";"   15478";"   15475";"   15470";"       0";"       0";"       0";"       0";"       0";"       0"
"2129";"A043595";"2017MM05";"     431";"     215";"     216";"   21751";"   10761";"   10990";"   21751";"   21742";"   21227";"       0";"       0";"       0";"       0";"       0";"       0"
"2130";"A043595";"2017MM06";"     386";"     188";"     198";"   18631";"    9394";"    9237";"   18631";"   18624";"   17704";"       3";"       0";"       3";"       3";"       0";"       0"
"2131";"A043595";"2017KW02";"    1158";"     568";"     590";"   55860";"   27521";"   28339";"   55860";"   55841";"   54401";"       3";"       0";"       3";"       3";"       0";"       0"
"2132";"A043595";"2017MM07";"     407";"     209";"     198";"   22693";"   10567";"   12126";"   22693";"   22686";"   21316";"       2";"       0";"       0";"       0";"       0";"       0"
"2133";"A043595";"2017MM08";"     390";"     195";"     195";"   23054";"   12265";"   10789";"   23054";"   23051";"   21614";"       0";"       0";"       0";"       0";"       0";"       0"
"2134";"A043595";"2017MM09";"     440";"     221";"     219";"   21509";"   10474";"   11035";"   21509";"   21502";"   20173";"       0";"       0";"       0";"       0";"       0";"       0"
"2135";"A043595";"2017KW03";"    1237";"     625";"     612";"   67256";"   33306";"   33950";"   67256";"   67239";"   63103";"       2";"       0";"       0";"       0";"       0";"       0"
"2136";"A043595";"2017MM10";"     411";"     208";"     203";"   18813";"   10203";"    8610";"   18813";"   18807";"   17618";"       0";"       0";"       0";"       0";"       0";"       0"
"2137";"A043595";"2017MM11";"     416";"     206";"     210";"    3222";"    1669";"    1553";"    3222";"    3216";"    3214";"       0";"       0";"       0";"       0";"       0";"       0"
"2138";"A043595";"2017MM12";"     356";"     180";"     176";"    3889";"    2314";"    1575";"    3889";"    3889";"    3889";"       0";"       0";"       0";"       0";"       0";"       0"
"2139";"A043595";"2017KW04";"    1183";"     594";"     589";"   25924";"   14186";"   11738";"   25924";"   25912";"   24721";"       0";"       0";"       0";"       0";"       0";"       0"
"2140";"A043595";"2017JJ00";"    4419";"    2211";"    2208";"  167544";"   84101";"   83443";"  167544";"  167484";"  160481";"       5";"       0";"       3";"       3";"       0";"       0"
"2141";"A043595";"2018MM01";"     291";"     145";"     146";"    3286";"    1727";"    1559";"    3286";"    3285";"    3220";"       0";"       0";"       0";"       0";"       0";"       0"
"2142";"A043595";"2018MM02";"     334";"     170";"     164";"    3022";"    1475";"    1547";"    3022";"    3017";"    3017";"       2";"       0";"       0";"       0";"       0";"       0"
"2143";"A043595";"2018MM03";"     371";"     190";"     181";"    5502";"    2854";"    2648";"    5502";"    5500";"    5331";"       0";"       0";"       0";"       0";"       0";"       0"
"2144";"A043595";"2018KW01";"     996";"     505";"     491";"   11810";"    6056";"    5754";"   11810";"   11802";"   11568";"       2";"       0";"       0";"       0";"       0";"       0"
"2145";"A043595";"2018MM04";"     505";"     255";"     250";"   17477";"    6559";"   10918";"   17477";"   17090";"   13493";"     378";"       0";"       0";"       0";"       0";"       0"
"2146";"A043595";"2018MM05";"     575";"     290";"     285";"   34418";"   16309";"   18109";"   34418";"   33542";"   28618";"     871";"     183";"       0";"       0";"       0";"       0"
"2147";"A043595";"2018MM06";"     491";"     243";"     248";"   31299";"   15338";"   15961";"   31299";"   30569";"   27054";"     726";"       5";"       0";"       0";"       0";"       0"
"2148";"A043595";"2018KW02";"    1571";"     788";"     783";"   83194";"   38206";"   44988";"   83194";"   81201";"   69165";"    1975";"     188";"       0";"       0";"       0";"       0"
"2149";"A043595";"2018MM07";"     641";"     319";"     322";"   46636";"   20027";"   26609";"   46636";"   43918";"   35579";"    2712";"       0";"       0";"       0";"       0";"       0"
"2150";"A043595";"2018MM08";"     685";"     341";"     344";"   53040";"   27323";"   25717";"   53040";"   50391";"   39554";"    2646";"       0";"       0";"       0";"       0";"       0"
"2151";"A043595";"2018MM09";"     589";"     298";"     291";"   34945";"   17282";"   17663";"   34945";"   34062";"   29365";"     871";"       0";"       0";"       0";"       0";"       0"
"2152";"A043595";"2018KW03";"    1915";"     958";"     957";"  134621";"   64632";"   69989";"  134621";"  128371";"  104498";"    6229";"       0";"       0";"       0";"       0";"       0"
"2153";"A043595";"2018MM10";"     620";"     310";"     310";"   32462";"   17276";"   15186";"   32462";"   31964";"   24932";"     496";"       0";"       0";"       0";"       0";"       0"
"2154";"A043595";"2018MM11";"     479";"     240";"     239";"    7528";"    4505";"    3023";"    7528";"    6414";"    3679";"    1114";"       0";"       0";"       0";"       0";"       0"
"2155";"A043595";"2018MM12";"     436";"     219";"     217";"    5498";"    2797";"    2701";"    5498";"    3817";"    3768";"    1673";"       0";"       2";"       2";"       0";"       0"
"2156";"A043595";"2018KW04";"    1535";"     769";"     766";"   45488";"   24578";"   20910";"   45488";"   42195";"   32379";"    3283";"       0";"       2";"       2";"       0";"       0"
"2157";"A043595";"2018JJ00";"    6017";"    3020";"    2997";"  275113";"  133472";"  141641";"  275113";"  263569";"  217610";"   11489";"     188";"       2";"       2";"       0";"       0"
"2158";"A043595";"2019MM01";"     413";"     202";"     211";"    6140";"    3411";"    2729";"    6140";"    3588";"    3415";"    2552";"       0";"       4";"       4";"       0";"       0"
"2159";"A043595";"2019MM02";"     456";"     227";"     229";"    6817";"    3319";"    3498";"    6817";"    4146";"    4144";"    2668";"       0";"       0";"       0";"       0";"       0"
"2160";"A043595";"2019MM03";"     454";"     226";"     228";"    6914";"    3556";"    3358";"    6914";"    4916";"    3487";"    1998";"       0";"       0";"       0";"       0";"       0"
"2161";"A043595";"2019KW01";"    1323";"     655";"     668";"   19871";"   10286";"    9585";"   19871";"   12650";"   11046";"    7218";"       0";"       4";"       4";"       0";"       0"
"2162";"A043595";"2019MM04";"     622";"     311";"     311";"   32795";"   13965";"   18830";"   32795";"   31465";"   22388";"    1329";"       0";"       0";"       0";"       0";"       0"
"2163";"A043595";"2019MM05";"     723";"     362";"     361";"   49734";"   24125";"   25609";"   49734";"   48641";"   37323";"    1090";"       0";"       0";"       0";"       0";"       0"
"2164";"A043595";"2019MM06";"     678";"     336";"     342";"   50048";"   24632";"   25416";"   50048";"   48328";"   37219";"    1713";"       0";"       2";"       2";"       0";"       0"
"2165";"A043595";"2019KW02";"    2023";"    1009";"    1014";"  132577";"   62722";"   69855";"  132577";"  128434";"   96930";"    4132";"       0";"       2";"       2";"       0";"       0"
"2166";"A043595";"2019MM07";"     808";"     403";"     405";"   69715";"   31761";"   37954";"   69715";"   65026";"   46607";"    4684";"       0";"       0";"       0";"       0";"       0"
"2167";"A043595";"2019MM08";"     713";"     355";"     358";"   76289";"   39711";"   36578";"   76289";"   70281";"   48990";"    5998";"       0";"       0";"       0";"       0";"       0"
"2168";"A043595";"2019MM09";"     641";"     324";"     317";"   59255";"   30421";"   28834";"   59255";"   56272";"   41350";"    2983";"       0";"       0";"       0";"       0";"       0"
"2169";"A043595";"2019KW03";"    2162";"    1082";"    1080";"  205259";"  101893";"  103366";"  205259";"  191579";"  136947";"   13665";"       0";"       0";"       0";"       0";"       0"
"2170";"A043595";"2019MM10";"     616";"     313";"     303";"   46190";"   25714";"   20476";"   46190";"   42918";"   30531";"    3271";"       0";"       0";"       0";"       0";"       0"
"2171";"A043595";"2019MM11";"     564";"     279";"     285";"   16446";"    8551";"    7895";"   16446";"   12120";"    9140";"    4326";"       0";"       0";"       0";"       0";"       0"
"2172";"A043595";"2019MM12";"     511";"     263";"     248";"   15634";"    8390";"    7244";"   15634";"   10145";"    9425";"    5488";"       0";"       0";"       0";"       0";"       0"
"2173";"A043595";"2019KW04";"    1691";"     855";"     836";"   78270";"   42655";"   35615";"   78270";"   65183";"   49096";"   13085";"       0";"       0";"       0";"       0";"       0"
"2174";"A043595";"2019JJ00";"    7199";"    3601";"    3598";"  435977";"  217556";"  218421";"  435977";"  397846";"  294019";"   38100";"       0";"       6";"       6";"       0";"       0"
"2175";"A043595";"2020MM01";"     474";"     238";"     236";"   15115";"    8177";"    6938";"   15115";"    9549";"    9055";"    5566";"       0";"       0";"       0";"       0";"       0"
"2176";"A043595";"2020MM02";"     476";"     237";"     239";"   14354";"    7233";"    7121";"   14354";"    8083";"    7046";"    6271";"       0";"       0";"       0";"       0";"       0"
"2177";"A043595";"2020MM03";"     485";"     236";"     249";"    7242";"    4398";"    2844";"    7242";"    4364";"    3655";"    2873";"       0";"       2";"       2";"       0";"       0"
"2178";"A043595";"2020KW01";"    1435";"     711";"     724";"   36711";"   19808";"   16903";"   36711";"   21996";"   19756";"   14710";"       0";"       2";"       2";"       0";"       0"
"2179";"A043595";"2020MM04";"     329";"     162";"     167";"       5";"       0";"       5";"       5";"       3";"       3";"       0";"       0";"       0";"       0";"       0";"       0"
"2180";"A043595";"2020MM05";"     452";"     226";"     226";"       4";"       2";"       2";"       4";"       4";"       4";"       0";"       0";"       0";"       0";"       0";"       0"
"2181";"A043595";"2020MM06";"     489";"     246";"     243";"     389";"     188";"     201";"     389";"     384";"     384";"       3";"       0";"       3";"       0";"       0";"       3"
"2182";"A043595";"2020KW02";"    1270";"     634";"     636";"     398";"     190";"     208";"     398";"     391";"     391";"       3";"       0";"       3";"       0";"       0";"       3"
"2183";"A043595";"2020MM07";"     621";"     311";"     310";"   12952";"    5620";"    7332";"   12952";"   12952";"   12952";"       0";"       0";"       0";"       0";"       0";"       0"
"2184";"A043595";"2020MM08";"     615";"     310";"     305";"   16818";"    9354";"    7464";"   16818";"   16814";"   16814";"       4";"       4";"       0";"       0";"       0";"       0"
"2185";"A043595";"2020MM09";"     516";"     257";"     259";"    5511";"    3189";"    2322";"    5511";"    5510";"    5510";"       1";"       0";"       0";"       0";"       0";"       0"
"2186";"A043595";"2020KW03";"    1752";"     878";"     874";"   35281";"   18163";"   17118";"   35281";"   35276";"   35276";"       5";"       4";"       0";"       0";"       0";"       0"
"2187";"A043595";"2020MM10";"     587";"     292";"     295";"    4710";"    2583";"    2127";"    4710";"    4710";"    4706";"       0";"       0";"       0";"       0";"       0";"       0"
"2188";"A043595";"2020MM11";"     548";"     277";"     271";"    2139";"    1270";"     869";"    2139";"    2137";"    2137";"       2";"       0";"       2";"       2";"       0";"       0"
"2189";"A043595";"2020MM12";"     535";"     274";"     261";"    1841";"     765";"    1076";"    1841";"    1840";"    1838";"       0";"       0";"       0";"       0";"       0";"       0"
"2190";"A043595";"2020KW04";"    1670";"     843";"     827";"    8690";"    4618";"    4072";"    8690";"    8687";"    8681";"       2";"       0";"       2";"       2";"       0";"       0"
"2191";"A043595";"2020JJ00";"    6127";"    3066";"    3061";"   81080";"   42779";"   38301";"   81080";"   66350";"   64104";"   14720";"       4";"       7";"       4";"       0";"       3"
"2192";"A043595";"2021MM01";"     468";"     234";"     234";"    1049";"     625";"     424";"    1049";"    1049";"    1049";"       0";"       0";"       0";"       0";"       0";"       0"
"2193";"A043595";"2021MM02";"     537";"     267";"     270";"     448";"     346";"     102";"     448";"     447";"     447";"       0";"       0";"       0";"       0";"       0";"       0"
"2194";"A043595";"2021MM03";"     560";"     281";"     279";"     373";"     197";"     176";"     373";"     373";"     373";"       0";"       0";"       0";"       0";"       0";"       0"
"2195";"A043595";"2021KW01";"    1565";"     782";"     783";"    1870";"    1168";"     702";"    1870";"    1869";"    1869";"       0";"       0";"       0";"       0";"       0";"       0"
"2196";"A043595";"2021MM04";"     563";"     278";"     285";"    1474";"     571";"     903";"    1474";"    1473";"    1473";"       0";"       0";"       0";"       0";"       0";"       0"
"2197";"A043595";"2021MM05";"     555";"     272";"     283";"    2223";"     993";"    1230";"    2223";"    2221";"    2221";"       1";"       0";"       1";"       1";"       0";"       0"
"2198";"A043595";"2021MM06";"     460";"     226";"     234";"    4454";"    1425";"    3029";"    4454";"    4454";"    3963";"       0";"       0";"       0";"       0";"       0";"       0"
"2199";"A043595";"2021KW02";"    1578";"     776";"     802";"    8151";"    2989";"    5162";"    8151";"    8148";"    7657";"       1";"       0";"       1";"       1";"       0";"       0"
"2200";"A043595";"2021MM07";"     583";"     295";"     288";"   22399";"    9366";"   13033";"   22399";"   22397";"   18591";"       0";"       0";"       0";"       0";"       0";"       0"
"2201";"A043595";"2021MM08";"     600";"     296";"     304";"   24199";"   13550";"   10649";"   24199";"   24199";"   18179";"       0";"       0";"       0";"       0";"       0";"       0"
"2202";"A043595";"2021MM09";"     623";"     312";"     311";"   16364";"    8706";"    7658";"   16364";"   16363";"   14348";"       0";"       0";"       0";"       0";"       0";"       0"
"2203";"A043595";"2021KW03";"    1806";"     903";"     903";"   62962";"   31622";"   31340";"   62962";"   62959";"   51118";"       0";"       0";"       0";"       0";"       0";"       0"
"2204";"A043595";"2021MM10";"     656";"     333";"     323";"   17826";"    9944";"    7882";"   17826";"   17817";"   14989";"       9";"       1";"       8";"       8";"       0";"       0"
"2205";"A043595";"2021MM11";"     523";"     258";"     265";"    3744";"    2039";"    1705";"    3744";"    3744";"    3523";"       0";"       0";"       0";"       0";"       0";"       0"
"2206";"A043595";"2021MM12";"     473";"     237";"     236";"    3093";"    1757";"    1336";"    3093";"    3090";"    2961";"       0";"       0";"       0";"       0";"       0";"       0"
"2207";"A043595";"2021KW04";"    1652";"     828";"     824";"   24663";"   13740";"   10923";"   24663";"   24651";"   21473";"       9";"       1";"       8";"       8";"       0";"       0"
"2208";"A043595";"2021JJ00";"    6601";"    3289";"    3312";"   97646";"   49519";"   48127";"   97646";"   97627";"   82117";"      10";"       1";"       9";"       9";"       0";"       0"
"2209";"A043595";"2022MM01";"     431";"     213";"     218";"    5880";"    4341";"    1539";"    5880";"    5880";"    5335";"       0";"       0";"       0";"       0";"       0";"       0"
"2210";"A043595";"2022MM02";"     398";"     201";"     197";"    3288";"    1633";"    1655";"    3288";"    3287";"    3215";"       0";"       0";"       0";"       0";"       0";"       0"
"2211";"A043595";"2022MM03";"     434";"     212";"     222";"    3371";"    1566";"    1805";"    3371";"    3369";"    3306";"       0";"       0";"       0";"       0";"       0";"       0"
"2212";"A043595";"2022KW01";"    1263";"     626";"     637";"   12539";"    7540";"    4999";"   12539";"   12536";"   11856";"       0";"       0";"       0";"       0";"       0";"       0"
"2213";"A043595";"2022MM04";"     514";"     255";"     259";"   15386";"    6884";"    8502";"   15386";"   15204";"   10931";"     182";"       0";"     182";"       0";"     182";"       0"
"2214";"A043595";"2022MM05";"     542";"     266";"     276";"   22019";"   11067";"   10952";"   22019";"   22000";"   16355";"      17";"      17";"       0";"       0";"       0";"       0"
"2215";"A043595";"2022MM06";"     599";"     297";"     302";"   20728";"    9980";"   10748";"   20728";"   20549";"   15175";"     179";"      19";"       0";"       0";"       0";"       0"
"2216";"A043595";"2022KW02";"    1655";"     818";"     837";"   58133";"   27931";"   30202";"   58133";"   57753";"   42461";"     378";"      36";"     182";"       0";"     182";"       0"
"2217";"A043595";"2022MM07";"     712";"     362";"     350";"   45778";"   19550";"   26228";"   45778";"   41096";"   27715";"    4682";"       0";"      96";"      96";"       0";"       0"
"2218";"A043595";"2022MM08";"     696";"     346";"     350";"   53999";"   28498";"   25501";"   53999";"   49526";"   32407";"    4470";"       0";"       0";"       0";"       0";"       0"
"2219";"A043595";"2022MM09";"     640";"     317";"     323";"   35942";"   18226";"   17716";"   35942";"   35751";"   24082";"     189";"       0";"       0";"       0";"       0";"       0"
"2220";"A043595";"2022KW03";"    2048";"    1025";"    1023";"  135719";"   66274";"   69445";"  135719";"  126373";"   84204";"    9341";"       0";"      96";"      96";"       0";"       0"
"2221";"A043595";"2022MM10";"     587";"     297";"     290";"   30520";"   16969";"   13551";"   30520";"   30515";"   19227";"       0";"       0";"       0";"       0";"       0";"       0"
"2222";"A043595";"2022MM11";"     460";"     225";"     235";"   15032";"    8046";"    6986";"   15032";"   14943";"   12144";"      87";"       0";"      87";"      87";"       0";"       0"
"2223";"A043595";"2022MM12";"     396";"     199";"     197";"   14089";"    6517";"    7572";"   14089";"   14089";"   11206";"       0";"       0";"       0";"       0";"       0";"       0"
"2224";"A043595";"2022KW04";"    1443";"     721";"     722";"   59641";"   31532";"   28109";"   59641";"   59547";"   42577";"      87";"       0";"      87";"      87";"       0";"       0"
"2225";"A043595";"2022JJ00";"    6409";"    3190";"    3219";"  266032";"  133277";"  132755";"  266032";"  256209";"  181098";"    9806";"      36";"     365";"     183";"     182";"       0"
"2226";"A043595";"2023MM01";"     376";"     185";"     191";"   13518";"    7286";"    6232";"   13518";"   13516";"   11507";"       2";"       2";"       0";"       0";"       0";"       0"
"2227";"A043595";"2023MM02";"     331";"     166";"     165";"   13883";"    7333";"    6550";"   13883";"   13662";"   11374";"     221";"       0";"     221";"     221";"       0";"       0"
"2228";"A043595";"2023MM03";"     423";"     207";"     216";"   15890";"    7945";"    7945";"   15890";"   15888";"   13668";"       0";"       0";"       0";"       0";"       0";"       0"
"2229";"A043595";"2023KW01";"    1130";"     558";"     572";"   43291";"   22564";"   20727";"   43291";"   43066";"   36549";"     223";"       2";"     221";"     221";"       0";"       0"
"2230";"A043595";"2023MM04";"     326";"     165";"     161";"   15696";"    7538";"    8158";"   15696";"   15512";"   12652";"     182";"       0";"       0";"       0";"       0";"       0"
"2231";"A043595";"2023MM05";"      60";"      25";"      35";"    3485";"    1881";"    1604";"    3485";"    3485";"    2968";"       0";"       0";"       0";"       0";"       0";"       0"
"2232";"A043595";"2023MM06";"       0";"       0";"       0";"       0";"       0";"       0";"       0";"       0";"       0";"       0";"       0";"       0";"       0";"       0";"       0"
"2233";"A043595";"2023KW02";"     386";"     190";"     196";"   19181";"    9419";"    9762";"   19181";"   18997";"   15620";"     182";"       0";"       0";"       0";"       0";"       0"
"2234";"A043595";"2023MM07";"     525";"     273";"     252";"   38134";"   16133";"   22001";"   38134";"   36943";"   26754";"    1175";"       0";"       0";"       0";"       0";"       0"
"2235";"A043595";"2023MM08";"     479";"     236";"     243";"   43360";"   22759";"   20601";"   43360";"   42137";"   29775";"    1219";"       0";"       1";"       1";"       0";"       0"
"2236";"A043595";"2023MM09";"     461";"     235";"     226";"   30777";"   15607";"   15170";"   30777";"   30767";"   24682";"       0";"       0";"       0";"       0";"       0";"       0"
"2237";"A043595";"2023KW03";"    1465";"     744";"     721";"  112271";"   54499";"   57772";"  112271";"  109847";"   81211";"    2394";"       0";"       1";"       1";"       0";"       0"
"2238";"A043595";"2023MM10";"     359";"     176";"     183";"   26376";"   14783";"   11593";"   26376";"   26376";"   19881";"       0";"       0";"       0";"       0";"       0";"       0"
"2239";"A043595";"2023MM11";"     278";"     138";"     140";"   10036";"    6101";"    3935";"   10036";"   10036";"    9372";"       0";"       0";"       0";"       0";"       0";"       0"
"2240";"A043595";"2023MM12";"     317";"     164";"     153";"   11997";"    4742";"    7255";"   11997";"   10920";"   10548";"    1075";"       0";"    1075";"    1075";"       0";"       0"
"2241";"A043595";"2023KW04";"     954";"     478";"     476";"   48409";"   25626";"   22783";"   48409";"   47332";"   39801";"    1075";"       0";"    1075";"    1075";"       0";"       0"
"2242";"A043595";"2023JJ00";"    3935";"    1970";"    1965";"  223152";"  112108";"  111044";"  223152";"  219242";"  173181";"    3874";"       2";"    1297";"    1297";"       0";"       0"
"2243";"A043595";"2024MM01";"     286";"     144";"     142";"   11753";"    7001";"    4752";"   11753";"   11753";"    9968";"       0";"       0";"       0";"       0";"       0";"       0"
"2244";"A043595";"2024MM02";"     256";"     126";"     130";"    9683";"    4749";"    4934";"    9683";"    9439";"    8753";"     244";"       0";"     244";"     244";"       0";"       0"
"2245";"A043595";"2024MM03";"     335";"     169";"     166";"   12074";"    5744";"    6330";"   12074";"   11996";"   11996";"      75";"       0";"      75";"      75";"       0";"       0"
"2246";"A043595";"2024KW01";"     877";"     439";"     438";"   33510";"   17494";"   16016";"   33510";"   33188";"   30717";"     319";"       0";"     319";"     319";"       0";"       0"
"2247";"A043595";"2024MM04";"     370";"     186";"     184";"   14244";"    6111";"    8133";"   14244";"   14219";"   12612";"      24";"      24";"       0";"       0";"       0";"       0"
"2248";"A043595";"2024MM05";"     383";"     190";"     193";"   25104";"   12338";"   12766";"   25104";"   24954";"   18957";"     146";"       0";"     146";"     146";"       0";"       0"
"2249";"A043595";"2024MM06";"     449";"     225";"     224";"   27255";"   13355";"   13900";"   27255";"   27251";"   22050";"       0";"       0";"       0";"       0";"       0";"       0"
"2250";"A043595";"2024KW02";"    1202";"     601";"     601";"   66603";"   31804";"   34799";"   66603";"   66424";"   53619";"     170";"      24";"     146";"     146";"       0";"       0"
"2251";"A043595";"2024MM07";"     461";"     234";"     227";"   31335";"   13789";"   17546";"   31335";"   30642";"   22867";"     693";"       0";"       0";"       0";"       0";"       0"
"2252";"A043595";"2024MM08";"     417";"     202";"     215";"   34009";"   18011";"   15998";"   34009";"   33326";"   24783";"     678";"       0";"       0";"       0";"       0";"       0"
"2253";"A043595";"2024MM09";"     357";"     176";"     181";"   26795";"   13620";"   13175";"   26795";"   26792";"   20114";"       0";"       0";"       0";"       0";"       0";"       0"
"2254";"A043595";"2024KW03";"    1235";"     612";"     623";"   92139";"   45420";"   46719";"   92139";"   90760";"   67764";"    1371";"       0";"       0";"       0";"       0";"       0"
"2255";"A043595";"2024MM10";"     327";"     165";"     162";"   22085";"   11780";"   10305";"   22085";"   22082";"   15741";"       0";"       0";"       0";"       0";"       0";"       0"
"2256";"A043595";"2024MM11";"     249";"     125";"     124";"    4550";"    2533";"    2017";"    4550";"    4541";"    4031";"       0";"       0";"       0";"       0";"       0";"       0"
"2257";"A043595";"2024MM12";"     262";"     129";"     133";"    4620";"    2263";"    2357";"    4620";"    4616";"    4612";"       0";"       0";"       0";"       0";"       0";"       0"
"2258";"A043595";"2024KW04";"     838";"     419";"     419";"   31255";"   16576";"   14679";"   31255";"   31239";"   24384";"       0";"       0";"       0";"       0";"       0";"       0"
"2259";"A043595";"2024JJ00";"    4152";"    2071";"    2081";"  223507";"  111294";"  112213";"  223507";"  221611";"  176484";"    1860";"      24";"     465";"     465";"       0";"       0"
"2260";"A043595";"2025MM01";"     232";"     120";"     112";"    5222";"    3026";"    2196";"    5222";"    5222";"    5010";"       0";"       0";"       0";"       0";"       0";"       0"
"2261";"A043595";"2025MM02";"     243";"     123";"     120";"    5935";"    2987";"    2948";"    5935";"    5935";"    5288";"       0";"       0";"       0";"       0";"       0";"       0"
"2262";"A043595";"2025MM03";"     364";"     182";"     182";"    6517";"    3323";"    3194";"    6517";"    6513";"    6248";"       0";"       0";"       0";"       0";"       0";"       0"
"2263";"A043595";"2025KW01";"     839";"     425";"     414";"   17674";"    9336";"    8338";"   17674";"   17670";"   16546";"       0";"       0";"       0";"       0";"       0";"       0"
"2264";"A043595";"2025MM04";"     366";"     183";"     183";"   17500";"    8159";"    9341";"   17500";"   17500";"   15606";"       0";"       0";"       0";"       0";"       0";"       0"
"2265";"A043595";"2025MM05";"     402";"     196";"     206";"   19740";"    9634";"   10106";"   19740";"   19718";"   19374";"       4";"       4";"       0";"       0";"       0";"       0"
"2266";"A043595";"2025MM06";"     446";"     217";"     229";"   22755";"   11346";"   11409";"   22755";"   22670";"   21451";"      83";"       2";"      81";"      81";"       0";"       0"
"2267";"A043595";"2025KW02";"    1214";"     596";"     618";"   59995";"   29139";"   30856";"   59995";"   59888";"   56431";"      87";"       6";"      81";"      81";"       0";"       0"
"2268";"A043595";"2025MM07";"     405";"     205";"     200";"   19152";"    8507";"   10645";"   19152";"   19149";"   19147";"       0";"       0";"       0";"       0";"       0";"       0"
"2269";"A043595";"2025MM08";"     360";"     179";"     181";"   20506";"   10877";"    9629";"   20506";"   20506";"   20506";"       0";"       0";"       0";"       0";"       0";"       0"
"2270";"A043593";"1997JJ00";"    4982";"    2490";"    2492";"   83151";"   40794";"   42357";"   83151";"       0";"       0";"       0";"       0";"       0";"       0";"       0";"       0"
"2271";"A043593";"1998JJ00";"    5330";"    2670";"    2660";"  114160";"   56822";"   57338";"  114160";"       0";"       0";"       0";"       0";"       0";"       0";"       0";"       0"
"2272";"A043593";"1999MM01";"     235";"     117";"     118";"    3196";"    1408";"    1788";"    3196";"       0";"       0";"       0";"       0";"       0";"       0";"       0";"       0"
"2273";"A043593";"1999MM02";"     215";"     107";"     108";"    2760";"    1315";"    1445";"    2760";"       0";"       0";"       0";"       0";"       0";"       0";"       0";"       0"
"2274";"A043593";"1999MM03";"     262";"     129";"     133";"    3872";"    1903";"    1969";"    3872";"       0";"       0";"       0";"       0";"       0";"       0";"       0";"       0"
"2275";"A043593";"1999KW01";"     712";"     353";"     359";"    9828";"    4626";"    5202";"    9828";"       0";"       0";"       0";"       0";"       0";"       0";"       0";"       0"
"2276";"A043593";"1999MM04";"     120";"      60";"      60";"    4527";"    1707";"    2820";"    4527";"       0";"       0";"       0";"       0";"       0";"       0";"       0";"       0"
"2277";"A043593";"1999MM05";"     168";"      87";"      81";"   11606";"    5733";"    5873";"   11606";"       0";"       0";"       0";"       0";"       0";"       0";"       0";"       0"
"2278";"A043593";"1999MM06";"     202";"     103";"      99";"   12635";"    6366";"    6269";"   12635";"       0";"       0";"       0";"       0";"       0";"       0";"       0";"       0"
"2279";"A043593";"1999KW02";"     490";"     250";"     240";"   28768";"   13806";"   14962";"   28768";"       0";"       0";"       0";"       0";"       0";"       0";"       0";"       0"
"2280";"A043593";"1999MM07";"     162";"      81";"      81";"   11160";"    5416";"    5744";"   11160";"       0";"       0";"       0";"       0";"       0";"       0";"       0";"       0"
"2281";"A043593";"1999MM08";"     156";"      79";"      77";"   12766";"    6699";"    6067";"   12766";"       0";"       0";"       0";"       0";"       0";"       0";"       0";"       0"
"2282";"A043593";"1999MM09";"     183";"      90";"      93";"   13182";"    6618";"    6564";"   13182";"       0";"       0";"       0";"       0";"       0";"       0";"       0";"       0"
"2283";"A043593";"1999KW03";"     501";"     250";"     251";"   37108";"   18733";"   18375";"   37108";"       0";"       0";"       0";"       0";"       0";"       0";"       0";"       0"
"2284";"A043593";"1999MM10";"     155";"      77";"      78";"    9985";"    6032";"    3953";"    9985";"       0";"       0";"       0";"       0";"       0";"       0";"       0";"       0"
"2285";"A043593";"1999MM11";"     132";"      68";"      64";"    2539";"    1248";"    1291";"    2539";"       0";"       0";"       0";"       0";"       0";"       0";"       0";"       0"
"2286";"A043593";"1999MM12";"      84";"      42";"      42";"    1940";"     970";"     970";"    1940";"       0";"       0";"       0";"       0";"       0";"       0";"       0";"       0"
"2287";"A043593";"1999KW04";"     371";"     187";"     184";"   14464";"    8250";"    6214";"   14464";"       0";"       0";"       0";"       0";"       0";"       0";"       0";"       0"
"2288";"A043593";"1999JJ00";"    2074";"    1040";"    1034";"   90168";"   45415";"   44753";"   90168";"       0";"       0";"       0";"       0";"       0";"       0";"       0";"       0"
"2289";"A043593";"2000MM01";"      86";"      42";"      44";"    2327";"    1072";"    1255";"    2327";"    2327";"    2327";"       0";"       0";"       0";"       0";"       0";"       0"
"2290";"A043593";"2000MM02";"      92";"      47";"      45";"    2118";"    1304";"     814";"    2118";"    2118";"    2118";"       0";"       0";"       0";"       0";"       0";"       0"
"2291";"A043593";"2000MM03";"     105";"      53";"      52";"    3432";"    1787";"    1645";"    3432";"    3432";"    3312";"       0";"       0";"       0";"       0";"       0";"       0"
"2292";"A043593";"2000KW01";"     283";"     142";"     141";"    7877";"    4163";"    3714";"    7877";"    7877";"    7757";"       0";"       0";"       0";"       0";"       0";"       0"
"2293";"A043593";"2000MM04";"     121";"      58";"      63";"    2796";"    1127";"    1669";"    2796";"    2796";"    2796";"       0";"       0";"       0";"       0";"       0";"       0"
"2294";"A043593";"2000MM05";"     184";"      92";"      92";"    6155";"    2961";"    3194";"    6155";"    6155";"    5470";"       0";"       0";"       0";"       0";"       0";"       0"
"2295";"A043593";"2000MM06";"     160";"      80";"      80";"    5243";"    2637";"    2606";"    5243";"    5243";"    4752";"       0";"       0";"       0";"       0";"       0";"       0"
"2296";"A043593";"2000KW02";"     465";"     230";"     235";"   14194";"    6725";"    7469";"   14194";"   14194";"   13018";"       0";"       0";"       0";"       0";"       0";"       0"
"2297";"A043593";"2000MM07";"     130";"      65";"      65";"    9917";"    4376";"    5541";"    9917";"    9917";"    9592";"       0";"       0";"       0";"       0";"       0";"       0"
"2298";"A043593";"2000MM08";"     148";"      74";"      74";"   16084";"    8467";"    7617";"   16084";"   16084";"   15086";"       0";"       0";"       0";"       0";"       0";"       0"
"2299";"A043593";"2000MM09";"     164";"      82";"      82";"   15039";"    7257";"    7782";"   15039";"   15039";"   14496";"       0";"       0";"       0";"       0";"       0";"       0"
"2300";"A043593";"2000KW03";"     442";"     221";"     221";"   41040";"   20100";"   20940";"   41040";"   41040";"   39174";"       0";"       0";"       0";"       0";"       0";"       0"
"2301";"A043593";"2000MM10";"     144";"      72";"      72";"   10694";"    6588";"    4106";"   10694";"   10694";"   10397";"       0";"       0";"       0";"       0";"       0";"       0"
"2302";"A043593";"2000MM11";"      88";"      48";"      40";"    2546";"    1211";"    1335";"    2546";"    2546";"    2507";"       0";"       0";"       0";"       0";"       0";"       0"
"2303";"A043593";"2000MM12";"      53";"      30";"      23";"    1915";"     992";"     923";"    1915";"    1915";"    1915";"       0";"       0";"       0";"       0";"       0";"       0"
"2304";"A043593";"2000KW04";"     285";"     150";"     135";"   15155";"    8791";"    6364";"   15155";"   15155";"   14819";"       0";"       0";"       0";"       0";"       0";"       0"
"2305";"A043593";"2000JJ00";"    1475";"     743";"     732";"   78266";"   39779";"   38487";"   78266";"   78266";"   74768";"       0";"       0";"       0";"       0";"       0";"       0"
"2306";"A043593";"2001MM01";"      48";"      26";"      22";"    2430";"    1161";"    1269";"    2430";"    2430";"    2430";"       0";"       0";"       0";"       0";"       0";"       0"
"2307";"A043593";"2001MM02";"      53";"      28";"      25";"    2107";"    1097";"    1010";"    2107";"    2107";"    2107";"       0";"       0";"       0";"       0";"       0";"       0"
"2308";"A043593";"2001MM03";"      59";"      28";"      31";"    3232";"    1566";"    1666";"    3232";"    3232";"    2976";"       0";"       0";"       0";"       0";"       0";"       0"
"2309";"A043593";"2001KW01";"     160";"      82";"      78";"    7769";"    3824";"    3945";"    7769";"    7769";"    7513";"       0";"       0";"       0";"       0";"       0";"       0"
"2310";"A043593";"2001MM04";"     121";"      58";"      63";"    4514";"    1581";"    2933";"    4514";"    4514";"    4514";"       0";"       0";"       0";"       0";"       0";"       0"
"2311";"A043593";"2001MM05";"     142";"      72";"      70";"   14319";"    6899";"    7420";"   14319";"   14319";"   13233";"       0";"       0";"       0";"       0";"       0";"       0"
"2312";"A043593";"2001MM06";"     135";"      66";"      69";"    8674";"    2410";"    6264";"    8674";"    8674";"    7991";"       0";"       0";"       0";"       0";"       0";"       0"
"2313";"A043593";"2001KW02";"     398";"     196";"     202";"   27507";"   10890";"   16617";"   27507";"   27507";"   25738";"       0";"       0";"       0";"       0";"       0";"       0"
"2314";"A043593";"2001MM07";"     161";"      80";"      81";"   14641";"    6934";"    7707";"   14641";"   14640";"   13488";"       1";"       1";"       0";"       0";"       0";"       0"
"2315";"A043593";"2001MM08";"     146";"      70";"      76";"   13376";"    7264";"    6112";"   13376";"   13376";"   12370";"       0";"       0";"       0";"       0";"       0";"       0"
"2316";"A043593";"2001MM09";"     302";"     151";"     151";"   13178";"    6248";"    6930";"   13178";"   12995";"   12024";"       0";"       0";"       0";"       0";"       0";"       0"
"2317";"A043593";"2001KW03";"     609";"     301";"     308";"   41195";"   20446";"   20749";"   41195";"   41011";"   37882";"       1";"       1";"       0";"       0";"       0";"       0"
"2318";"A043593";"2001MM10";"     311";"     155";"     156";"   12815";"    7603";"    5212";"   12815";"   12815";"   11573";"       0";"       0";"       0";"       0";"       0";"       0"
"2319";"A043593";"2001MM11";"     200";"      98";"     102";"    2460";"    1097";"    1363";"    2460";"    2460";"    2460";"       0";"       0";"       0";"       0";"       0";"       0"
"2320";"A043593";"2001MM12";"     150";"      76";"      74";"    2474";"    1255";"    1219";"    2474";"    2474";"    2474";"       0";"       0";"       0";"       0";"       0";"       0"
"2321";"A043593";"2001KW04";"     661";"     329";"     332";"   17749";"    9955";"    7794";"   17749";"   17749";"   16507";"       0";"       0";"       0";"       0";"       0";"       0"
"2322";"A043593";"2001JJ00";"    1828";"     908";"     920";"   94220";"   45115";"   49105";"   94220";"   94036";"   87640";"       1";"       1";"       0";"       0";"       0";"       0"
"2323";"A043593";"2002MM01";"     188";"      92";"      96";"    2764";"    1308";"    1456";"    2764";"    2764";"    2764";"       0";"       0";"       0";"       0";"       0";"       0"
"2324";"A043593";"2002MM02";"     172";"      86";"      86";"    2587";"    1258";"    1329";"    2587";"    2587";"    2587";"       0";"       0";"       0";"       0";"       0";"       0"
"2325";"A043593";"2002MM03";"     211";"     106";"     105";"    3737";"    1820";"    1917";"    3737";"    3737";"    3672";"       0";"       0";"       0";"       0";"       0";"       0"
"2326";"A043593";"2002KW01";"     571";"     284";"     287";"    9088";"    4386";"    4702";"    9088";"    9088";"    9023";"       0";"       0";"       0";"       0";"       0";"       0"
"2327";"A043593";"2002MM04";"     239";"     120";"     119";"    7810";"    2965";"    4845";"    7810";"    7810";"    7382";"       0";"       0";"       0";"       0";"       0";"       0"
"2328";"A043593";"2002MM05";"     339";"     172";"     167";"   17283";"    8612";"    8671";"   17283";"   17283";"   15769";"       0";"       0";"       0";"       0";"       0";"       0"
"2329";"A043593";"2002MM06";"     324";"     162";"     162";"   12879";"    6311";"    6568";"   12879";"   12879";"   11617";"       0";"       0";"       0";"       0";"       0";"       0"
"2330";"A043593";"2002KW02";"     902";"     454";"     448";"   37972";"   17888";"   20084";"   37972";"   37972";"   34768";"       0";"       0";"       0";"       0";"       0";"       0"
"2331";"A043593";"2002MM07";"     200";"      98";"     102";"   17831";"    8856";"    8975";"   17831";"   17831";"   16080";"       0";"       0";"       0";"       0";"       0";"       0"
"2332";"A043593";"2002MM08";"     137";"      69";"      68";"   10929";"    5790";"    5139";"   10929";"   10929";"   10001";"       0";"       0";"       0";"       0";"       0";"       0"
"2333";"A043593";"2002MM09";"     166";"      84";"      82";"   14700";"    6969";"    7731";"   14700";"   14700";"   13468";"       0";"       0";"       0";"       0";"       0";"       0"
"2334";"A043593";"2002KW03";"     503";"     251";"     252";"   43460";"   21615";"   21845";"   43460";"   43460";"   39549";"       0";"       0";"       0";"       0";"       0";"       0"
"2335";"A043593";"2002MM10";"     154";"      77";"      77";"   11139";"    6749";"    4390";"   11139";"   11139";"    9123";"       0";"       0";"       0";"       0";"       0";"       0"
"2336";"A043593";"2002MM11";"      59";"      29";"      30";"    2886";"    1258";"    1628";"    2886";"    2886";"    2886";"       0";"       0";"       0";"       0";"       0";"       0"
"2337";"A043593";"2002MM12";"      61";"      31";"      30";"    2921";"    1449";"    1472";"    2921";"    2921";"    2921";"       0";"       0";"       0";"       0";"       0";"       0"
"2338";"A043593";"2002KW04";"     274";"     137";"     137";"   16946";"    9456";"    7490";"   16946";"   16946";"   14930";"       0";"       0";"       0";"       0";"       0";"       0"
"2339";"A043593";"2002JJ00";"    2250";"    1126";"    1124";"  107466";"   53345";"   54121";"  107466";"  107466";"   98270";"       0";"       0";"       0";"       0";"       0";"       0"
"2340";"A043593";"2003MM01";"      51";"      25";"      26";"    3362";"    1620";"    1742";"    3362";"    3362";"    3362";"       0";"       0";"       0";"       0";"       0";"       0"
"2341";"A043593";"2003MM02";"      42";"      21";"      21";"    3075";"    1615";"    1460";"    3075";"    3075";"    3075";"       0";"       0";"       0";"       0";"       0";"       0"
"2342";"A043593";"2003MM03";"      49";"      24";"      25";"    3565";"    1829";"    1736";"    3565";"    3565";"    3504";"       0";"       0";"       0";"       0";"       0";"       0"
"2343";"A043593";"2003KW01";"     142";"      70";"      72";"   10002";"    5064";"    4938";"   10002";"   10002";"    9941";"       0";"       0";"       0";"       0";"       0";"       0"
"2344";"A043593";"2003MM04";"      98";"      49";"      49";"    7439";"    2773";"    4666";"    7439";"    7439";"    7103";"       0";"       0";"       0";"       0";"       0";"       0"
"2345";"A043593";"2003MM05";"     225";"     114";"     111";"   17049";"    8375";"    8674";"   17049";"   17049";"   15668";"       0";"       0";"       0";"       0";"       0";"       0"
"2346";"A043593";"2003MM06";"     182";"      92";"      90";"   15252";"    7409";"    7843";"   15252";"   15252";"   14358";"       0";"       0";"       0";"       0";"       0";"       0"
"2347";"A043593";"2003KW02";"     505";"     255";"     250";"   39740";"   18557";"   21183";"   39740";"   39740";"   37129";"       0";"       0";"       0";"       0";"       0";"       0"
"2348";"A043593";"2003MM07";"     228";"     114";"     114";"   22852";"   11545";"   11307";"   22852";"   22852";"   20488";"       0";"       0";"       0";"       0";"       0";"       0"
"2349";"A043593";"2003MM08";"     210";"     105";"     105";"   15587";"    8253";"    7334";"   15587";"   15587";"   14321";"       0";"       0";"       0";"       0";"       0";"       0"
"2350";"A043593";"2003MM09";"     206";"     103";"     103";"   17514";"    8367";"    9147";"   17514";"   17514";"   16447";"       0";"       0";"       0";"       0";"       0";"       0"
"2351";"A043593";"2003KW03";"     644";"     322";"     322";"   55953";"   28165";"   27788";"   55953";"   55953";"   51256";"       0";"       0";"       0";"       0";"       0";"       0"
"2352";"A043593";"2003MM10";"     199";"      99";"     100";"   16083";"    9080";"    7003";"   16083";"   16083";"   14007";"       0";"       0";"       0";"       0";"       0";"       0"
"2353";"A043593";"2003MM11";"     125";"      63";"      62";"    7515";"    3330";"    4185";"    7515";"    7515";"    7458";"       0";"       0";"       0";"       0";"       0";"       0"
"2354";"A043593";"2003MM12";"     111";"      57";"      54";"    8314";"    4190";"    4124";"    8314";"    8314";"    8314";"       0";"       0";"       0";"       0";"       0";"       0"
"2355";"A043593";"2003KW04";"     435";"     219";"     216";"   31912";"   16600";"   15312";"   31912";"   31912";"   29779";"       0";"       0";"       0";"       0";"       0";"       0"
"2356";"A043593";"2003JJ00";"    1726";"     866";"     860";"  137607";"   68386";"   69221";"  137607";"  137607";"  128105";"       0";"       0";"       0";"       0";"       0";"       0"
"2357";"A043593";"2004MM01";"     110";"      54";"      56";"    6907";"    3247";"    3660";"    6907";"    6907";"    6907";"       0";"       0";"       0";"       0";"       0";"       0"
"2358";"A043593";"2004MM02";"     159";"      78";"      81";"    8780";"    4436";"    4344";"    8780";"    8780";"    8780";"       0";"       0";"       0";"       0";"       0";"       0"
"2359";"A043593";"2004MM03";"     181";"      90";"      91";"   10276";"    5225";"    5051";"   10276";"   10276";"   10206";"       0";"       0";"       0";"       0";"       0";"       0"
"2360";"A043593";"2004KW01";"     450";"     222";"     228";"   25963";"   12908";"   13055";"   25963";"   25963";"   25893";"       0";"       0";"       0";"       0";"       0";"       0"
"2361";"A043593";"2004MM04";"     183";"      91";"      92";"   11424";"    4969";"    6455";"   11424";"   11424";"   10588";"       0";"       0";"       0";"       0";"       0";"       0"
"2362";"A043593";"2004MM05";"     199";"      99";"     100";"   13993";"    6777";"    7216";"   13993";"   13993";"    9647";"       0";"       0";"       0";"       0";"       0";"       0"
"2363";"A043593";"2004MM06";"     196";"      97";"      99";"   12585";"    6672";"    5913";"   12585";"   12585";"    9059";"       0";"       0";"       0";"       0";"       0";"       0"
"2364";"A043593";"2004KW02";"     578";"     287";"     291";"   38002";"   18418";"   19584";"   38002";"   38002";"   29294";"       0";"       0";"       0";"       0";"       0";"       0"
"2365";"A043593";"2004MM07";"     180";"      91";"      89";"   12049";"    5586";"    6463";"   12049";"   12049";"    8629";"       0";"       0";"       0";"       0";"       0";"       0"
"2366";"A043593";"2004MM08";"     164";"      82";"      82";"   12319";"    6560";"    5759";"   12319";"   12319";"    8811";"       0";"       0";"       0";"       0";"       0";"       0"
"2367";"A043593";"2004MM09";"     185";"      91";"      94";"   13171";"    6439";"    6732";"   13171";"   13171";"    9733";"       0";"       0";"       0";"       0";"       0";"       0"
"2368";"A043593";"2004KW03";"     529";"     264";"     265";"   37539";"   18585";"   18954";"   37539";"   37539";"   27173";"       0";"       0";"       0";"       0";"       0";"       0"
"2369";"A043593";"2004MM10";"     171";"      85";"      86";"   10211";"    5940";"    4271";"   10211";"   10207";"    7192";"       4";"       4";"       0";"       0";"       0";"       0"
"2370";"A043593";"2004MM11";"     111";"      53";"      58";"    4056";"    1843";"    2213";"    4056";"    4056";"    3894";"       0";"       0";"       0";"       0";"       0";"       0"
"2371";"A043593";"2004MM12";"      86";"      44";"      42";"    3447";"    1867";"    1580";"    3447";"    3447";"    3154";"       0";"       0";"       0";"       0";"       0";"       0"
"2372";"A043593";"2004KW04";"     368";"     182";"     186";"   17714";"    9650";"    8064";"   17714";"   17710";"   14240";"       4";"       4";"       0";"       0";"       0";"       0"
"2373";"A043593";"2004JJ00";"    1925";"     955";"     970";"  119218";"   59561";"   59657";"  119218";"  119214";"   96600";"       4";"       4";"       0";"       0";"       0";"       0"
"2374";"A043593";"2005MM01";"      96";"      47";"      49";"    4387";"    2169";"    2218";"    4387";"    4387";"    4387";"       0";"       0";"       0";"       0";"       0";"       0"
"2375";"A043593";"2005MM02";"     108";"      53";"      55";"    4908";"    2478";"    2430";"    4908";"    4908";"    4908";"       0";"       0";"       0";"       0";"       0";"       0"
"2376";"A043593";"2005MM03";"     120";"      61";"      59";"    4737";"    2412";"    2325";"    4737";"    4737";"    4439";"       0";"       0";"       0";"       0";"       0";"       0"
"2377";"A043593";"2005KW01";"     324";"     161";"     163";"   14032";"    7059";"    6973";"   14032";"   14032";"   13734";"       0";"       0";"       0";"       0";"       0";"       0"
"2378";"A043593";"2005MM04";"     143";"      72";"      71";"    6130";"    2273";"    3857";"    6130";"    6130";"    5326";"       0";"       0";"       0";"       0";"       0";"       0"
"2379";"A043593";"2005MM05";"     253";"     128";"     125";"   17474";"    7834";"    9640";"   17474";"   17474";"   10857";"       0";"       0";"       0";"       0";"       0";"       0"
"2380";"A043593";"2005MM06";"     322";"     162";"     160";"   19585";"   11306";"    8279";"   19585";"   19585";"   11540";"       0";"       0";"       0";"       0";"       0";"       0"
"2381";"A043593";"2005KW02";"     718";"     362";"     356";"   43189";"   21413";"   21776";"   43189";"   43189";"   27723";"       0";"       0";"       0";"       0";"       0";"       0"
"2382";"A043593";"2005MM07";"     202";"     100";"     102";"   10771";"    4863";"    5908";"   10771";"   10771";"    7624";"       0";"       0";"       0";"       0";"       0";"       0"
"2383";"A043593";"2005MM08";"     239";"     117";"     122";"   19054";"    9898";"    9156";"   19054";"   19054";"   11366";"       0";"       0";"       0";"       0";"       0";"       0"
"2384";"A043593";"2005MM09";"     243";"     120";"     123";"   16298";"    7954";"    8344";"   16298";"   16298";"   11495";"       0";"       0";"       0";"       0";"       0";"       0"
"2385";"A043593";"2005KW03";"     684";"     337";"     347";"   46123";"   22715";"   23408";"   46123";"   46123";"   30485";"       0";"       0";"       0";"       0";"       0";"       0"
"2386";"A043593";"2005MM10";"     183";"      90";"      93";"   11352";"    6884";"    4468";"   11352";"   11352";"    5896";"       0";"       0";"       0";"       0";"       0";"       0"
"2387";"A043593";"2005MM11";"     132";"      68";"      64";"    4768";"    2283";"    2485";"    4768";"    4768";"    4621";"       0";"       0";"       0";"       0";"       0";"       0"
"2388";"A043593";"2005MM12";"      98";"      49";"      49";"    3330";"    1653";"    1677";"    3330";"    3330";"    3187";"       0";"       0";"       0";"       0";"       0";"       0"
"2389";"A043593";"2005KW04";"     413";"     207";"     206";"   19450";"   10820";"    8630";"   19450";"   19450";"   13704";"       0";"       0";"       0";"       0";"       0";"       0"
"2390";"A043593";"2005JJ00";"    2139";"    1067";"    1072";"  122794";"   62007";"   60787";"  122794";"  122794";"   85646";"       0";"       0";"       0";"       0";"       0";"       0"
"2391";"A043593";"2006MM01";"     112";"      56";"      56";"    4467";"    2174";"    2293";"    4467";"    4467";"    4467";"       0";"       0";"       0";"       0";"       0";"       0"
"2392";"A043593";"2006MM02";"     113";"      58";"      55";"    5006";"    2549";"    2457";"    5006";"    4883";"    4566";"     123";"       0";"       0";"       0";"       0";"       0"
"2393";"A043593";"2006MM03";"     113";"      57";"      56";"    4520";"    2231";"    2289";"    4520";"    4520";"    4520";"       0";"       0";"       0";"       0";"       0";"       0"
"2394";"A043593";"2006KW01";"     338";"     171";"     167";"   13993";"    6954";"    7039";"   13993";"   13870";"   13553";"     123";"       0";"       0";"       0";"       0";"       0"
"2395";"A043593";"2006MM04";"     129";"      64";"      65";"    6644";"    2682";"    3962";"    6644";"    6644";"    5820";"       0";"       0";"       0";"       0";"       0";"       0"
"2396";"A043593";"2006MM05";"     247";"     123";"     124";"   18759";"    8981";"    9778";"   18759";"   18759";"   14318";"       0";"       0";"       0";"       0";"       0";"       0"
"2397";"A043593";"2006MM06";"     246";"     125";"     121";"   16444";"    8278";"    8166";"   16444";"   16444";"   13399";"       0";"       0";"       0";"       0";"       0";"       0"
"2398";"A043593";"2006KW02";"     622";"     312";"     310";"   41847";"   19941";"   21906";"   41847";"   41847";"   33537";"       0";"       0";"       0";"       0";"       0";"       0"
"2399";"A043593";"2006MM07";"     208";"     103";"     105";"   13275";"    6330";"    6945";"   13275";"   13275";"   10936";"       0";"       0";"       0";"       0";"       0";"       0"
"2400";"A043593";"2006MM08";"     213";"     107";"     106";"   19035";"    9850";"    9185";"   19035";"   19035";"   14456";"       0";"       0";"       0";"       0";"       0";"       0"
"2401";"A043593";"2006MM09";"     232";"     118";"     114";"   16846";"    8158";"    8688";"   16846";"   16846";"   13350";"       0";"       0";"       0";"       0";"       0";"       0"
"2402";"A043593";"2006KW03";"     653";"     328";"     325";"   49156";"   24338";"   24818";"   49156";"   49156";"   38742";"       0";"       0";"       0";"       0";"       0";"       0"
"2403";"A043593";"2006MM10";"     245";"     123";"     122";"   13531";"    8006";"    5525";"   13531";"   13531";"   10254";"       0";"       0";"       0";"       0";"       0";"       0"
"2404";"A043593";"2006MM11";"     209";"     102";"     107";"    5952";"    2835";"    3117";"    5952";"    5952";"    5748";"       0";"       0";"       0";"       0";"       0";"       0"
"2405";"A043593";"2006MM12";"     169";"      85";"      84";"    4533";"    2283";"    2250";"    4533";"    4533";"    4435";"       0";"       0";"       0";"       0";"       0";"       0"
"2406";"A043593";"2006KW04";"     623";"     310";"     313";"   24016";"   13124";"   10892";"   24016";"   24016";"   20437";"       0";"       0";"       0";"       0";"       0";"       0"
"2407";"A043593";"2006JJ00";"    2236";"    1121";"    1115";"  129012";"   64357";"   64655";"  129012";"  128889";"  106269";"     123";"       0";"       0";"       0";"       0";"       0"
"2408";"A043593";"2007MM01";"     183";"      92";"      91";"    5408";"    2623";"    2785";"    5408";"    5408";"    5330";"       0";"       0";"       0";"       0";"       0";"       0"
"2409";"A043593";"2007MM02";"     180";"      89";"      91";"    5252";"    2590";"    2662";"    5252";"    5252";"    5023";"       0";"       0";"       0";"       0";"       0";"       0"
"2410";"A043593";"2007MM03";"     185";"      92";"      93";"    5841";"    2908";"    2933";"    5841";"    5841";"    5554";"       0";"       0";"       0";"       0";"       0";"       0"
"2411";"A043593";"2007KW01";"     548";"     273";"     275";"   16501";"    8121";"    8380";"   16501";"   16501";"   15907";"       0";"       0";"       0";"       0";"       0";"       0"
"2412";"A043593";"2007MM04";"     212";"     106";"     106";"    8314";"    3609";"    4705";"    8314";"    8314";"    7579";"       0";"       0";"       0";"       0";"       0";"       0"
"2413";"A043593";"2007MM05";"     288";"     145";"     143";"   18568";"    8807";"    9761";"   18568";"   18568";"   15961";"       0";"       0";"       0";"       0";"       0";"       0"
"2414";"A043593";"2007MM06";"     274";"     135";"     139";"   15756";"    8052";"    7704";"   15756";"   15756";"   13913";"       0";"       0";"       0";"       0";"       0";"       0"
"2415";"A043593";"2007KW02";"     774";"     386";"     388";"   42638";"   20468";"   22170";"   42638";"   42638";"   37453";"       0";"       0";"       0";"       0";"       0";"       0"
"2416";"A043593";"2007MM07";"     256";"     128";"     128";"   17958";"    8280";"    9678";"   17958";"   17958";"   14747";"       0";"       0";"       0";"       0";"       0";"       0"
"2417";"A043593";"2007MM08";"     290";"     144";"     146";"   19107";"   10150";"    8957";"   19107";"   19107";"   15542";"       0";"       0";"       0";"       0";"       0";"       0"
"2418";"A043593";"2007MM09";"     257";"     130";"     127";"   16755";"    8195";"    8560";"   16755";"   16755";"   14684";"       0";"       0";"       0";"       0";"       0";"       0"
"2419";"A043593";"2007KW03";"     803";"     402";"     401";"   53820";"   26625";"   27195";"   53820";"   53820";"   44973";"       0";"       0";"       0";"       0";"       0";"       0"
"2420";"A043593";"2007MM10";"     261";"     131";"     130";"   14445";"    8351";"    6094";"   14445";"   14445";"   12481";"       0";"       0";"       0";"       0";"       0";"       0"
"2421";"A043593";"2007MM11";"     157";"      78";"      79";"    4830";"    2260";"    2570";"    4830";"    4830";"    4830";"       0";"       0";"       0";"       0";"       0";"       0"
"2422";"A043593";"2007MM12";"     103";"      52";"      51";"    3492";"    1756";"    1736";"    3492";"    3492";"    3492";"       0";"       0";"       0";"       0";"       0";"       0"
"2423";"A043593";"2007KW04";"     521";"     261";"     260";"   22767";"   12367";"   10400";"   22767";"   22767";"   20803";"       0";"       0";"       0";"       0";"       0";"       0"
"2424";"A043593";"2007JJ00";"    2646";"    1322";"    1324";"  135726";"   67581";"   68145";"  135726";"  135726";"  119136";"       0";"       0";"       0";"       0";"       0";"       0"
"2425";"A043593";"2008MM01";"     138";"      70";"      68";"    4750";"    2232";"    2518";"    4750";"    4750";"    4725";"       0";"       0";"       0";"       0";"       0";"       0"
"2426";"A043593";"2008MM02";"     137";"      67";"      70";"    4845";"    2453";"    2392";"    4845";"    4845";"    4825";"       0";"       0";"       0";"       0";"       0";"       0"
"2427";"A043593";"2008MM03";"     136";"      68";"      68";"    5302";"    2720";"    2582";"    5302";"    5302";"    5201";"       0";"       0";"       0";"       0";"       0";"       0"
"2428";"A043593";"2008KW01";"     411";"     205";"     206";"   14897";"    7405";"    7492";"   14897";"   14897";"   14751";"       0";"       0";"       0";"       0";"       0";"       0"
"2429";"A043593";"2008MM04";"     196";"      96";"     100";"    9020";"    3238";"    5782";"    9020";"    9020";"    8055";"       0";"       0";"       0";"       0";"       0";"       0"
"2430";"A043593";"2008MM05";"     310";"     154";"     156";"   22151";"   10933";"   11218";"   22151";"   22151";"   17687";"       0";"       0";"       0";"       0";"       0";"       0"
"2431";"A043593";"2008MM06";"     313";"     157";"     156";"   20158";"   10346";"    9812";"   20158";"   20158";"   16375";"       0";"       0";"       0";"       0";"       0";"       0"
"2432";"A043593";"2008KW02";"     819";"     407";"     412";"   51329";"   24517";"   26812";"   51329";"   51329";"   42117";"       0";"       0";"       0";"       0";"       0";"       0"
"2433";"A043593";"2008MM07";"     253";"     126";"     127";"   22223";"   11105";"   11118";"   22223";"   22223";"   16862";"       0";"       0";"       0";"       0";"       0";"       0"
"2434";"A043593";"2008MM08";"     226";"     113";"     113";"   16330";"    8573";"    7757";"   16330";"   16330";"   13214";"       0";"       0";"       0";"       0";"       0";"       0"
"2435";"A043593";"2008MM09";"     267";"     132";"     135";"   20445";"    9871";"   10574";"   20445";"   20445";"   16052";"       0";"       0";"       0";"       0";"       0";"       0"
"2436";"A043593";"2008KW03";"     746";"     371";"     375";"   58998";"   29549";"   29449";"   58998";"   58998";"   46128";"       0";"       0";"       0";"       0";"       0";"       0"
"2437";"A043593";"2008MM10";"     236";"     116";"     120";"   16456";"    9530";"    6926";"   16456";"   16456";"   12021";"       0";"       0";"       0";"       0";"       0";"       0"
"2438";"A043593";"2008MM11";"     118";"      60";"      58";"    4280";"    2117";"    2163";"    4280";"    4280";"    4122";"       0";"       0";"       0";"       0";"       0";"       0"
"2439";"A043593";"2008MM12";"      68";"      33";"      35";"    2989";"    1574";"    1415";"    2989";"    2989";"    2989";"       0";"       0";"       0";"       0";"       0";"       0"
"2440";"A043593";"2008KW04";"     422";"     209";"     213";"   23725";"   13221";"   10504";"   23725";"   23725";"   19132";"       0";"       0";"       0";"       0";"       0";"       0"
"2441";"A043593";"2008JJ00";"    2398";"    1192";"    1206";"  148949";"   74692";"   74257";"  148949";"  148949";"  122128";"       0";"       0";"       0";"       0";"       0";"       0"
"2442";"A043593";"2009MM01";"      80";"      41";"      39";"    3968";"    1715";"    2253";"    3968";"    3968";"    3968";"       0";"       0";"       0";"       0";"       0";"       0"
"2443";"A043593";"2009MM02";"      76";"      38";"      38";"    4081";"    2159";"    1922";"    4081";"    4081";"    4081";"       0";"       0";"       0";"       0";"       0";"       0"
"2444";"A043593";"2009MM03";"     105";"      53";"      52";"    4851";"    2404";"    2447";"    4851";"    4851";"    4398";"       0";"       0";"       0";"       0";"       0";"       0"
"2445";"A043593";"2009KW01";"     261";"     132";"     129";"   12900";"    6278";"    6622";"   12900";"   12900";"   12447";"       0";"       0";"       0";"       0";"       0";"       0"
"2446";"A043593";"2009MM04";"     141";"      71";"      70";"    7241";"    2737";"    4504";"    7241";"    7241";"    6319";"       0";"       0";"       0";"       0";"       0";"       0"
"2447";"A043593";"2009MM05";"     215";"     104";"     111";"   17220";"    8297";"    8923";"   17220";"   17220";"   13913";"       0";"       0";"       0";"       0";"       0";"       0"
"2448";"A043593";"2009MM06";"     209";"     103";"     106";"   17348";"    8886";"    8462";"   17348";"   17348";"   14262";"       0";"       0";"       0";"       0";"       0";"       0"
"2449";"A043593";"2009KW02";"     565";"     278";"     287";"   41809";"   19920";"   21889";"   41809";"   41809";"   34494";"       0";"       0";"       0";"       0";"       0";"       0"
"2450";"A043593";"2009MM07";"     221";"     111";"     110";"   22411";"   10508";"   11903";"   22411";"   22411";"   17551";"       0";"       0";"       0";"       0";"       0";"       0"
"2451";"A043593";"2009MM08";"     212";"     105";"     107";"   17744";"    9680";"    8064";"   17744";"   17744";"   14366";"       0";"       0";"       0";"       0";"       0";"       0"
"2452";"A043593";"2009MM09";"     226";"     113";"     113";"   18094";"    8591";"    9503";"   18094";"   18094";"   14241";"       0";"       0";"       0";"       0";"       0";"       0"
"2453";"A043593";"2009KW03";"     659";"     329";"     330";"   58249";"   28779";"   29470";"   58249";"   58249";"   46158";"       0";"       0";"       0";"       0";"       0";"       0"
"2454";"A043593";"2009MM10";"     211";"     105";"     106";"   15558";"    8986";"    6572";"   15558";"   15558";"   11839";"       0";"       0";"       0";"       0";"       0";"       0"
"2455";"A043593";"2009MM11";"     108";"      54";"      54";"    3915";"    1878";"    2037";"    3915";"    3915";"    3470";"       0";"       0";"       0";"       0";"       0";"       0"
"2456";"A043593";"2009MM12";"      72";"      35";"      37";"    3613";"    1894";"    1719";"    3613";"    3613";"    3613";"       0";"       0";"       0";"       0";"       0";"       0"
"2457";"A043593";"2009KW04";"     391";"     194";"     197";"   23086";"   12758";"   10328";"   23086";"   23086";"   18922";"       0";"       0";"       0";"       0";"       0";"       0"
"2458";"A043593";"2009JJ00";"    1876";"     933";"     943";"  136044";"   67735";"   68309";"  136044";"  136044";"  112021";"       0";"       0";"       0";"       0";"       0";"       0"
"2459";"A043593";"2010MM01";"      77";"      39";"      38";"    3302";"    1376";"    1926";"    3302";"    3302";"    3302";"       0";"       0";"       0";"       0";"       0";"       0"
"2460";"A043593";"2010MM02";"      82";"      42";"      40";"    3791";"    1921";"    1870";"    3791";"    3791";"    3530";"       0";"       0";"       0";"       0";"       0";"       0"
"2461";"A043593";"2010MM03";"     111";"      56";"      55";"    4935";"    2634";"    2301";"    4935";"    4935";"    4621";"       0";"       0";"       0";"       0";"       0";"       0"
"2462";"A043593";"2010KW01";"     270";"     137";"     133";"   12028";"    5931";"    6097";"   12028";"   12028";"   11453";"       0";"       0";"       0";"       0";"       0";"       0"
"2463";"A043593";"2010MM04";"      95";"      49";"      46";"    5473";"    2141";"    3332";"    5473";"    5473";"    4196";"       0";"       0";"       0";"       0";"       0";"       0"
"2464";"A043593";"2010MM05";"     210";"     104";"     106";"   17357";"    7751";"    9606";"   17357";"   17357";"   14018";"       0";"       0";"       0";"       0";"       0";"       0"
"2465";"A043593";"2010MM06";"     232";"     116";"     116";"   17011";"    8916";"    8095";"   17011";"   17011";"   13708";"       0";"       0";"       0";"       0";"       0";"       0"
"2466";"A043593";"2010KW02";"     537";"     269";"     268";"   39841";"   18808";"   21033";"   39841";"   39841";"   31922";"       0";"       0";"       0";"       0";"       0";"       0"
"2467";"A043593";"2010MM07";"     188";"      94";"      94";"   16825";"    7747";"    9078";"   16825";"   16825";"   13696";"       0";"       0";"       0";"       0";"       0";"       0"
"2468";"A043593";"2010MM08";"     209";"     106";"     103";"   17872";"    9559";"    8313";"   17872";"   17872";"   14087";"       0";"       0";"       0";"       0";"       0";"       0"
"2469";"A043593";"2010MM09";"     201";"     101";"     100";"   16804";"    8189";"    8615";"   16804";"   16804";"   13386";"       0";"       0";"       0";"       0";"       0";"       0"
"2470";"A043593";"2010KW03";"     598";"     301";"     297";"   51501";"   25495";"   26006";"   51501";"   51501";"   41169";"       0";"       0";"       0";"       0";"       0";"       0"
"2471";"A043593";"2010MM10";"     177";"      86";"      91";"   12639";"    7283";"    5356";"   12639";"   12639";"    8741";"       0";"       0";"       0";"       0";"       0";"       0"
"2472";"A043593";"2010MM11";"      96";"      47";"      49";"    3531";"    1677";"    1854";"    3531";"    3531";"    3433";"       0";"       0";"       0";"       0";"       0";"       0"
"2473";"A043593";"2010MM12";"      68";"      35";"      33";"    3119";"    1601";"    1518";"    3119";"    3119";"    3119";"       0";"       0";"       0";"       0";"       0";"       0"
"2474";"A043593";"2010KW04";"     341";"     168";"     173";"   19289";"   10561";"    8728";"   19289";"   19289";"   15293";"       0";"       0";"       0";"       0";"       0";"       0"
"2475";"A043593";"2010JJ00";"    1746";"     875";"     871";"  122659";"   60795";"   61864";"  122659";"  122659";"   99837";"       0";"       0";"       0";"       0";"       0";"       0"
"2476";"A043593";"2011MM01";"      77";"      40";"      37";"    3268";"    1413";"    1855";"    3268";"    3268";"    3268";"       0";"       0";"       0";"       0";"       0";"       0"
"2477";"A043593";"2011MM02";"      84";"      42";"      42";"    3884";"    2073";"    1811";"    3884";"    3884";"    3884";"       0";"       0";"       0";"       0";"       0";"       0"
"2478";"A043593";"2011MM03";"     103";"      50";"      53";"    4290";"    2158";"    2132";"    4290";"    4290";"    4290";"       0";"       0";"       0";"       0";"       0";"       0"
"2479";"A043593";"2011KW01";"     264";"     132";"     132";"   11442";"    5644";"    5798";"   11442";"   11442";"   11442";"       0";"       0";"       0";"       0";"       0";"       0"
"2480";"A043593";"2011MM04";"     108";"      56";"      52";"    5173";"    2028";"    3145";"    5173";"    5173";"    4475";"       0";"       0";"       0";"       0";"       0";"       0"
"2481";"A043593";"2011MM05";"     210";"     106";"     104";"   15817";"    7362";"    8455";"   15817";"   15817";"   12113";"       0";"       0";"       0";"       0";"       0";"       0"
"2482";"A043593";"2011MM06";"     219";"     108";"     111";"   15380";"    7927";"    7453";"   15380";"   15380";"   12084";"       0";"       0";"       0";"       0";"       0";"       0"
"2483";"A043593";"2011KW02";"     537";"     270";"     267";"   36370";"   17317";"   19053";"   36370";"   36370";"   28672";"       0";"       0";"       0";"       0";"       0";"       0"
"2484";"A043593";"2011MM07";"     196";"      97";"      99";"   12622";"    6084";"    6538";"   12622";"   12622";"   10118";"       0";"       0";"       0";"       0";"       0";"       0"
"2485";"A043593";"2011MM08";"     198";"      99";"      99";"   18931";"    9269";"    9662";"   18931";"   18931";"   14428";"       0";"       0";"       0";"       0";"       0";"       0"
"2486";"A043593";"2011MM09";"     211";"     106";"     105";"   17497";"    9102";"    8395";"   17497";"   17497";"   13910";"       0";"       0";"       0";"       0";"       0";"       0"
"2487";"A043593";"2011KW03";"     605";"     302";"     303";"   49050";"   24455";"   24595";"   49050";"   49050";"   38456";"       0";"       0";"       0";"       0";"       0";"       0"
"2488";"A043593";"2011MM10";"     162";"      80";"      82";"   11189";"    6557";"    4632";"   11189";"   11189";"    7596";"       0";"       0";"       0";"       0";"       0";"       0"
"2489";"A043593";"2011MM11";"      68";"      34";"      34";"    2902";"    1361";"    1541";"    2902";"    2902";"    2771";"       0";"       0";"       0";"       0";"       0";"       0"
"2490";"A043593";"2011MM12";"      51";"      26";"      25";"    3374";"    1670";"    1704";"    3374";"    3374";"    3374";"       0";"       0";"       0";"       0";"       0";"       0"
"2491";"A043593";"2011KW04";"     281";"     140";"     141";"   17465";"    9588";"    7877";"   17465";"   17465";"   13741";"       0";"       0";"       0";"       0";"       0";"       0"
"2492";"A043593";"2011JJ00";"    1687";"     844";"     843";"  114327";"   57004";"   57323";"  114327";"  114327";"   92311";"       0";"       0";"       0";"       0";"       0";"       0"
"2493";"A043593";"2012MM01";"      87";"      43";"      44";"    4268";"    1927";"    2341";"    4268";"    4268";"    4268";"       0";"       0";"       0";"       0";"       0";"       0"
"2494";"A043593";"2012MM02";"      82";"      41";"      41";"    4805";"    2435";"    2370";"    4805";"    4805";"    4805";"       0";"       0";"       0";"       0";"       0";"       0"
"2495";"A043593";"2012MM03";"      79";"      40";"      39";"    5079";"    2701";"    2378";"    5079";"    5079";"    5079";"       0";"       0";"       0";"       0";"       0";"       0"
"2496";"A043593";"2012KW01";"     248";"     124";"     124";"   14152";"    7063";"    7089";"   14152";"   14152";"   14152";"       0";"       0";"       0";"       0";"       0";"       0"
"2497";"A043593";"2012MM04";"     112";"      56";"      56";"    6278";"    2410";"    3868";"    6278";"    6278";"    5748";"       0";"       0";"       0";"       0";"       0";"       0"
"2498";"A043593";"2012MM05";"     240";"     120";"     120";"   23064";"   10792";"   12272";"   23064";"   23064";"   19329";"       0";"       0";"       0";"       0";"       0";"       0"
"2499";"A043593";"2012MM06";"     270";"     133";"     137";"   24752";"   12765";"   11987";"   24752";"   24752";"   21635";"       0";"       0";"       0";"       0";"       0";"       0"
"2500";"A043593";"2012KW02";"     622";"     309";"     313";"   54094";"   25967";"   28127";"   54094";"   54094";"   46712";"       0";"       0";"       0";"       0";"       0";"       0"
"2501";"A043593";"2012MM07";"     269";"     136";"     133";"   24704";"   11283";"   13421";"   24704";"   24704";"   22233";"       0";"       0";"       0";"       0";"       0";"       0"
"2502";"A043593";"2012MM08";"     277";"     139";"     138";"   32461";"   16864";"   15597";"   32461";"   32461";"   28151";"       0";"       0";"       0";"       0";"       0";"       0"
"2503";"A043593";"2012MM09";"     260";"     130";"     130";"   26272";"   13296";"   12976";"   26272";"   26272";"   22625";"       0";"       0";"       0";"       0";"       0";"       0"
"2504";"A043593";"2012KW03";"     806";"     405";"     401";"   83437";"   41443";"   41994";"   83437";"   83437";"   73009";"       0";"       0";"       0";"       0";"       0";"       0"
"2505";"A043593";"2012MM10";"     211";"     106";"     105";"   18936";"   10839";"    8097";"   18936";"   18936";"   15047";"       0";"       0";"       0";"       0";"       0";"       0"
"2506";"A043593";"2012MM11";"      78";"      39";"      39";"    5008";"    2450";"    2558";"    5008";"    5008";"    4909";"       0";"       0";"       0";"       0";"       0";"       0"
"2507";"A043593";"2012MM12";"      71";"      35";"      36";"    5185";"    2564";"    2621";"    5185";"    5185";"    5185";"       0";"       0";"       0";"       0";"       0";"       0"
"2508";"A043593";"2012KW04";"     360";"     180";"     180";"   29129";"   15853";"   13276";"   29129";"   29129";"   25141";"       0";"       0";"       0";"       0";"       0";"       0"
"2509";"A043593";"2012JJ00";"    2036";"    1018";"    1018";"  180812";"   90326";"   90486";"  180812";"  180812";"  159014";"       0";"       0";"       0";"       0";"       0";"       0"
"2510";"A043593";"2013MM01";"      76";"      39";"      37";"    5947";"    2842";"    3105";"    5947";"    5947";"    5947";"       0";"       0";"       0";"       0";"       0";"       0"
"2511";"A043593";"2013MM02";"      79";"      40";"      39";"    5938";"    3098";"    2840";"    5938";"    5938";"    5938";"       0";"       0";"       0";"       0";"       0";"       0"
"2512";"A043593";"2013MM03";"      81";"      40";"      41";"    7329";"    3643";"    3686";"    7329";"    7329";"    7329";"       0";"       0";"       0";"       0";"       0";"       0"
"2513";"A043593";"2013KW01";"     236";"     119";"     117";"   19214";"    9583";"    9631";"   19214";"   19214";"   19214";"       0";"       0";"       0";"       0";"       0";"       0"
"2514";"A043593";"2013MM04";"      71";"      36";"      35";"    6282";"    2147";"    4135";"    6282";"    6282";"    5632";"       0";"       0";"       0";"       0";"       0";"       0"
"2515";"A043593";"2013MM05";"     221";"     110";"     111";"   25647";"   12415";"   13232";"   25647";"   25647";"   20357";"       0";"       0";"       0";"       0";"       0";"       0"
"2516";"A043593";"2013MM06";"     215";"     110";"     105";"   22933";"   11838";"   11095";"   22933";"   22933";"   18527";"       0";"       0";"       0";"       0";"       0";"       0"
"2517";"A043593";"2013KW02";"     507";"     256";"     251";"   54862";"   26400";"   28462";"   54862";"   54862";"   44516";"       0";"       0";"       0";"       0";"       0";"       0"
"2518";"A043593";"2013MM07";"     217";"     109";"     108";"   26411";"   12064";"   14347";"   26411";"   26411";"   20996";"       0";"       0";"       0";"       0";"       0";"       0"
"2519";"A043593";"2013MM08";"     211";"     107";"     104";"   25065";"   13566";"   11499";"   25065";"   25065";"   20579";"       0";"       0";"       0";"       0";"       0";"       0"
"2520";"A043593";"2013MM09";"     207";"     104";"     103";"   24314";"   12008";"   12306";"   24314";"   24314";"   19884";"       0";"       0";"       0";"       0";"       0";"       0"
"2521";"A043593";"2013KW03";"     635";"     320";"     315";"   75790";"   37638";"   38152";"   75790";"   75790";"   61459";"       0";"       0";"       0";"       0";"       0";"       0"
"2522";"A043593";"2013MM10";"     172";"      86";"      86";"   19232";"   10954";"    8278";"   19232";"   19232";"   13909";"       0";"       0";"       0";"       0";"       0";"       0"
"2523";"A043593";"2013MM11";"      45";"      23";"      22";"    3727";"    1838";"    1889";"    3727";"    3727";"    3539";"       0";"       0";"       0";"       0";"       0";"       0"
"2524";"A043593";"2013MM12";"      40";"      20";"      20";"    3387";"    1623";"    1764";"    3387";"    3387";"    3387";"       0";"       0";"       0";"       0";"       0";"       0"
"2525";"A043593";"2013KW04";"     257";"     129";"     128";"   26346";"   14415";"   11931";"   26346";"   26346";"   20835";"       0";"       0";"       0";"       0";"       0";"       0"
"2526";"A043593";"2013JJ00";"    1635";"     824";"     811";"  176212";"   88036";"   88176";"  176212";"  176212";"  146024";"       0";"       0";"       0";"       0";"       0";"       0"
"2527";"A043593";"2014MM01";"      49";"      24";"      25";"    4410";"    1932";"    2478";"    4410";"    4410";"    4410";"       0";"       0";"       0";"       0";"       0";"       0"
"2528";"A043593";"2014MM02";"      47";"      23";"      24";"    4745";"    2472";"    2273";"    4745";"    4745";"    4646";"       0";"       0";"       0";"       0";"       0";"       0"
"2529";"A043593";"2014MM03";"      59";"      29";"      30";"    5037";"    2664";"    2373";"    5037";"    5037";"    5037";"       0";"       0";"       0";"       0";"       0";"       0"
"2530";"A043593";"2014KW01";"     155";"      76";"      79";"   14192";"    7068";"    7124";"   14192";"   14192";"   14093";"       0";"       0";"       0";"       0";"       0";"       0"
"2531";"A043593";"2014MM04";"     110";"      55";"      55";"   10145";"    3980";"    6165";"   10145";"   10145";"    9055";"       0";"       0";"       0";"       0";"       0";"       0"
"2532";"A043593";"2014MM05";"     190";"      93";"      97";"   20268";"    9991";"   10277";"   20268";"   20268";"   15958";"       0";"       0";"       0";"       0";"       0";"       0"
"2533";"A043593";"2014MM06";"     234";"     115";"     119";"   20908";"   10715";"   10193";"   20908";"   20908";"   17395";"       0";"       0";"       0";"       0";"       0";"       0"
"2534";"A043593";"2014KW02";"     534";"     263";"     271";"   51321";"   24686";"   26635";"   51321";"   51321";"   42408";"       0";"       0";"       0";"       0";"       0";"       0"
"2535";"A043593";"2014MM07";"     254";"     127";"     127";"   24770";"   11595";"   13175";"   24770";"   24770";"   20370";"       0";"       0";"       0";"       0";"       0";"       0"
"2536";"A043593";"2014MM08";"     259";"     132";"     127";"   22617";"   12099";"   10518";"   22617";"   22472";"   19097";"     145";"     145";"       0";"       0";"       0";"       0"
"2537";"A043593";"2014MM09";"     233";"     116";"     117";"   21205";"   10471";"   10734";"   21205";"   21205";"   17699";"       0";"       0";"       0";"       0";"       0";"       0"
"2538";"A043593";"2014KW03";"     746";"     375";"     371";"   68592";"   34165";"   34427";"   68592";"   68447";"   57166";"     145";"     145";"       0";"       0";"       0";"       0"
"2539";"A043593";"2014MM10";"     210";"     106";"     104";"   18503";"   10398";"    8105";"   18503";"   18503";"   14697";"       0";"       0";"       0";"       0";"       0";"       0"
"2540";"A043593";"2014MM11";"     123";"      60";"      63";"    7873";"    3857";"    4016";"    7873";"    7873";"    7873";"       0";"       0";"       0";"       0";"       0";"       0"
"2541";"A043593";"2014MM12";"     122";"      61";"      61";"    8888";"    4250";"    4638";"    8888";"    8888";"    8888";"       0";"       0";"       0";"       0";"       0";"       0"
"2542";"A043593";"2014KW04";"     455";"     227";"     228";"   35264";"   18505";"   16759";"   35264";"   35264";"   31458";"       0";"       0";"       0";"       0";"       0";"       0"
"2543";"A043593";"2014JJ00";"    1890";"     941";"     949";"  169369";"   84424";"   84945";"  169369";"  169224";"  145125";"     145";"     145";"       0";"       0";"       0";"       0"
"2544";"A043593";"2015MM01";"     136";"      67";"      69";"    9473";"    4618";"    4855";"    9473";"    9473";"    9473";"       0";"       0";"       0";"       0";"       0";"       0"
"2545";"A043593";"2015MM02";"     117";"      60";"      57";"    9184";"    4606";"    4578";"    9184";"    9184";"    9184";"       0";"       0";"       0";"       0";"       0";"       0"
"2546";"A043593";"2015MM03";"     129";"      64";"      65";"    9320";"    4845";"    4475";"    9320";"    9320";"    9320";"       0";"       0";"       0";"       0";"       0";"       0"
"2547";"A043593";"2015KW01";"     382";"     191";"     191";"   27977";"   14069";"   13908";"   27977";"   27977";"   27977";"       0";"       0";"       0";"       0";"       0";"       0"
"2548";"A043593";"2015MM04";"     169";"      84";"      85";"   10020";"    4408";"    5612";"   10020";"   10020";"    8668";"       0";"       0";"       0";"       0";"       0";"       0"
"2549";"A043593";"2015MM05";"     265";"     133";"     132";"   23878";"   11628";"   12250";"   23878";"   23878";"   18361";"       0";"       0";"       0";"       0";"       0";"       0"
"2550";"A043593";"2015MM06";"     256";"     127";"     129";"   20455";"   10319";"   10136";"   20455";"   20455";"   15858";"       0";"       0";"       0";"       0";"       0";"       0"
"2551";"A043593";"2015KW02";"     690";"     344";"     346";"   54353";"   26355";"   27998";"   54353";"   54353";"   42887";"       0";"       0";"       0";"       0";"       0";"       0"
"2552";"A043593";"2015MM07";"     270";"     134";"     136";"   24945";"   12080";"   12865";"   24945";"   24945";"   19152";"       0";"       0";"       0";"       0";"       0";"       0"
"2553";"A043593";"2015MM08";"     244";"     121";"     123";"   20156";"   10914";"    9242";"   20156";"   20156";"   15684";"       0";"       0";"       0";"       0";"       0";"       0"
"2554";"A043593";"2015MM09";"     272";"     138";"     134";"   19980";"    9870";"   10110";"   19980";"   19980";"   15888";"       0";"       0";"       0";"       0";"       0";"       0"
"2555";"A043593";"2015KW03";"     786";"     393";"     393";"   65081";"   32864";"   32217";"   65081";"   65081";"   50724";"       0";"       0";"       0";"       0";"       0";"       0"
"2556";"A043593";"2015MM10";"     244";"     121";"     123";"   18012";"    9923";"    8089";"   18012";"   18012";"   13655";"       0";"       0";"       0";"       0";"       0";"       0"
"2557";"A043593";"2015MM11";"     134";"      66";"      68";"    7368";"    3574";"    3794";"    7368";"    7368";"    7311";"       0";"       0";"       0";"       0";"       0";"       0"
"2558";"A043593";"2015MM12";"     136";"      68";"      68";"    8088";"    4051";"    4037";"    8088";"    8088";"    8046";"       0";"       0";"       0";"       0";"       0";"       0"
"2559";"A043593";"2015KW04";"     514";"     255";"     259";"   33468";"   17548";"   15920";"   33468";"   33468";"   29012";"       0";"       0";"       0";"       0";"       0";"       0"
"2560";"A043593";"2015JJ00";"    2372";"    1183";"    1189";"  180879";"   90836";"   90043";"  180879";"  180879";"  150600";"       0";"       0";"       0";"       0";"       0";"       0"
"2561";"A043593";"2016MM01";"     130";"      65";"      65";"    7262";"    3491";"    3771";"    7262";"    7262";"    7223";"       0";"       0";"       0";"       0";"       0";"       0"
"2562";"A043593";"2016MM02";"     127";"      65";"      62";"    7368";"    3651";"    3717";"    7368";"    7368";"    7318";"       0";"       0";"       0";"       0";"       0";"       0"
"2563";"A043593";"2016MM03";"     153";"      76";"      77";"    8999";"    4709";"    4290";"    8999";"    8999";"    8934";"       0";"       0";"       0";"       0";"       0";"       0"
"2564";"A043593";"2016KW01";"     410";"     206";"     204";"   23629";"   11851";"   11778";"   23629";"   23629";"   23475";"       0";"       0";"       0";"       0";"       0";"       0"
"2565";"A043593";"2016MM04";"     163";"      83";"      80";"    9900";"    4163";"    5737";"    9900";"    9900";"    8961";"       0";"       0";"       0";"       0";"       0";"       0"
"2566";"A043593";"2016MM05";"     246";"     122";"     124";"   18481";"    9137";"    9344";"   18481";"   18481";"   14759";"       0";"       0";"       0";"       0";"       0";"       0"
"2567";"A043593";"2016MM06";"     222";"     111";"     111";"   15735";"    7904";"    7831";"   15735";"   15735";"   13548";"       0";"       0";"       0";"       0";"       0";"       0"
"2568";"A043593";"2016KW02";"     631";"     316";"     315";"   44116";"   21204";"   22912";"   44116";"   44116";"   37268";"       0";"       0";"       0";"       0";"       0";"       0"
"2569";"A043593";"2016MM07";"     228";"     115";"     113";"   16498";"    7788";"    8710";"   16498";"   16498";"   14219";"       0";"       0";"       0";"       0";"       0";"       0"
"2570";"A043593";"2016MM08";"     209";"     105";"     104";"   17669";"    9265";"    8404";"   17669";"   17669";"   14919";"       0";"       0";"       0";"       0";"       0";"       0"
"2571";"A043593";"2016MM09";"     257";"     129";"     128";"   16620";"    8252";"    8368";"   16620";"   16620";"   14451";"       0";"       0";"       0";"       0";"       0";"       0"
"2572";"A043593";"2016KW03";"     694";"     349";"     345";"   50787";"   25305";"   25482";"   50787";"   50787";"   43589";"       0";"       0";"       0";"       0";"       0";"       0"
"2573";"A043593";"2016MM10";"     287";"     143";"     144";"   14907";"    8091";"    6816";"   14907";"   14907";"   12344";"       0";"       0";"       0";"       0";"       0";"       0"
"2574";"A043593";"2016MM11";"     245";"     123";"     122";"    9117";"    4352";"    4765";"    9117";"    9117";"    9045";"       0";"       0";"       0";"       0";"       0";"       0"
"2575";"A043593";"2016MM12";"     215";"     109";"     106";"    9895";"    4892";"    5003";"    9895";"    9895";"    9852";"       0";"       0";"       0";"       0";"       0";"       0"
"2576";"A043593";"2016KW04";"     747";"     375";"     372";"   33919";"   17335";"   16584";"   33919";"   33919";"   31241";"       0";"       0";"       0";"       0";"       0";"       0"
"2577";"A043593";"2016JJ00";"    2482";"    1246";"    1236";"  152451";"   75695";"   76756";"  152451";"  152451";"  135573";"       0";"       0";"       0";"       0";"       0";"       0"
"2578";"A043593";"2017MM01";"     222";"     109";"     113";"    9616";"    4759";"    4857";"    9616";"    9616";"    9563";"       0";"       0";"       0";"       0";"       0";"       0"
"2579";"A043593";"2017MM02";"     226";"     113";"     113";"   10268";"    5167";"    5101";"   10268";"   10268";"   10217";"       0";"       0";"       0";"       0";"       0";"       0"
"2580";"A043593";"2017MM03";"     262";"     134";"     128";"   10986";"    5504";"    5482";"   10986";"   10986";"   10925";"       0";"       0";"       0";"       0";"       0";"       0"
"2581";"A043593";"2017KW01";"     710";"     356";"     354";"   30870";"   15430";"   15440";"   30870";"   30870";"   30705";"       0";"       0";"       0";"       0";"       0";"       0"
"2582";"A043593";"2017MM04";"     270";"     134";"     136";"   15907";"    7306";"    8601";"   15907";"   15907";"   15694";"       0";"       0";"       0";"       0";"       0";"       0"
"2583";"A043593";"2017MM05";"     363";"     181";"     182";"   23466";"   11444";"   12022";"   23466";"   23466";"   22281";"       0";"       0";"       0";"       0";"       0";"       0"
"2584";"A043593";"2017MM06";"     364";"     178";"     186";"   22028";"   10957";"   11071";"   22028";"   22028";"   21276";"       0";"       0";"       0";"       0";"       0";"       0"
"2585";"A043593";"2017KW02";"     997";"     493";"     504";"   61401";"   29707";"   31694";"   61401";"   61401";"   59251";"       0";"       0";"       0";"       0";"       0";"       0"
"2586";"A043593";"2017MM07";"     303";"     153";"     150";"   20642";"    9846";"   10796";"   20642";"   20642";"   20132";"       0";"       0";"       0";"       0";"       0";"       0"
"2587";"A043593";"2017MM08";"     314";"     153";"     161";"   23958";"   12113";"   11845";"   23958";"   23958";"   22982";"       0";"       0";"       0";"       0";"       0";"       0"
"2588";"A043593";"2017MM09";"     329";"     163";"     166";"   22617";"   11409";"   11208";"   22617";"   22617";"   21681";"       0";"       0";"       0";"       0";"       0";"       0"
"2589";"A043593";"2017KW03";"     946";"     469";"     477";"   67217";"   33368";"   33849";"   67217";"   67217";"   64795";"       0";"       0";"       0";"       0";"       0";"       0"
"2590";"A043593";"2017MM10";"     312";"     154";"     158";"   19145";"   10383";"    8762";"   19145";"   19145";"   18215";"       0";"       0";"       0";"       0";"       0";"       0"
"2591";"A043593";"2017MM11";"     244";"     123";"     121";"   11233";"    5463";"    5770";"   11233";"   11233";"   11190";"       0";"       0";"       0";"       0";"       0";"       0"
"2592";"A043593";"2017MM12";"     219";"     109";"     110";"   11920";"    5763";"    6157";"   11920";"   11920";"   11865";"       0";"       0";"       0";"       0";"       0";"       0"
"2593";"A043593";"2017KW04";"     775";"     386";"     389";"   42298";"   21609";"   20689";"   42298";"   42298";"   41270";"       0";"       0";"       0";"       0";"       0";"       0"
"2594";"A043593";"2017JJ00";"    3428";"    1704";"    1724";"  201786";"  100114";"  101672";"  201786";"  201786";"  196021";"       0";"       0";"       0";"       0";"       0";"       0"
"2595";"A043593";"2018MM01";"     240";"     120";"     120";"   11514";"    5589";"    5925";"   11514";"   11514";"   11470";"       0";"       0";"       0";"       0";"       0";"       0"
"2596";"A043593";"2018MM02";"     206";"     101";"     105";"   10930";"    5313";"    5617";"   10930";"   10930";"   10884";"       0";"       0";"       0";"       0";"       0";"       0"
"2597";"A043593";"2018MM03";"     285";"     141";"     144";"   12606";"    6696";"    5910";"   12606";"   12467";"   12424";"     139";"     139";"       0";"       0";"       0";"       0"
"2598";"A043593";"2018KW01";"     731";"     362";"     369";"   35050";"   17598";"   17452";"   35050";"   34911";"   34778";"     139";"     139";"       0";"       0";"       0";"       0"
"2599";"A043593";"2018MM04";"     384";"     190";"     194";"   14847";"    6498";"    8349";"   14847";"   14847";"   13881";"       0";"       0";"       0";"       0";"       0";"       0"
"2600";"A043593";"2018MM05";"     462";"     230";"     232";"   26376";"   13084";"   13292";"   26376";"   26376";"   24000";"       0";"       0";"       0";"       0";"       0";"       0"
"2601";"A043593";"2018MM06";"     447";"     222";"     225";"   23629";"   11979";"   11650";"   23629";"   23629";"   22162";"       0";"       0";"       0";"       0";"       0";"       0"
"2602";"A043593";"2018KW02";"    1293";"     642";"     651";"   64852";"   31561";"   33291";"   64852";"   64852";"   60043";"       0";"       0";"       0";"       0";"       0";"       0"
"2603";"A043593";"2018MM07";"     445";"     224";"     221";"   25712";"   11768";"   13944";"   25712";"   25712";"   24204";"       0";"       0";"       0";"       0";"       0";"       0"
"2604";"A043593";"2018MM08";"     428";"     216";"     212";"   28502";"   14661";"   13841";"   28502";"   28502";"   25332";"       0";"       0";"       0";"       0";"       0";"       0"
"2605";"A043593";"2018MM09";"     448";"     224";"     224";"   24297";"   12311";"   11986";"   24297";"   24297";"   22514";"       0";"       0";"       0";"       0";"       0";"       0"
"2606";"A043593";"2018KW03";"    1321";"     664";"     657";"   78511";"   38740";"   39771";"   78511";"   78511";"   72050";"       0";"       0";"       0";"       0";"       0";"       0"
"2607";"A043593";"2018MM10";"     402";"     202";"     200";"   21192";"   11332";"    9860";"   21192";"   21192";"   19460";"       0";"       0";"       0";"       0";"       0";"       0"
"2608";"A043593";"2018MM11";"     367";"     183";"     184";"   15204";"    7148";"    8056";"   15204";"   15204";"   14591";"       0";"       0";"       0";"       0";"       0";"       0"
"2609";"A043593";"2018MM12";"     321";"     159";"     162";"   13889";"    6828";"    7061";"   13889";"   13889";"   13889";"       0";"       0";"       0";"       0";"       0";"       0"
"2610";"A043593";"2018KW04";"    1090";"     544";"     546";"   50285";"   25308";"   24977";"   50285";"   50285";"   47940";"       0";"       0";"       0";"       0";"       0";"       0"
"2611";"A043593";"2018JJ00";"    4435";"    2212";"    2223";"  228698";"  113207";"  115491";"  228698";"  228559";"  214811";"     139";"     139";"       0";"       0";"       0";"       0"
"2612";"A043593";"2019MM01";"     170";"      84";"      86";"    8244";"    4158";"    4086";"    8244";"    8244";"    8244";"       0";"       0";"       0";"       0";"       0";"       0"
"2613";"A043593";"2019MM02";"     158";"      78";"      80";"    8771";"    4432";"    4339";"    8771";"    8771";"    8771";"       0";"       0";"       0";"       0";"       0";"       0"
"2614";"A043593";"2019MM03";"     270";"     134";"     136";"    9541";"    4903";"    4638";"    9541";"    9414";"    9414";"     127";"     127";"       0";"       0";"       0";"       0"
"2615";"A043593";"2019KW01";"     598";"     296";"     302";"   26556";"   13493";"   13063";"   26556";"   26429";"   26429";"     127";"     127";"       0";"       0";"       0";"       0"
"2616";"A043593";"2019MM04";"     291";"     146";"     145";"   13622";"    5917";"    7705";"   13622";"   13509";"   11870";"     113";"     113";"       0";"       0";"       0";"       0"
"2617";"A043593";"2019MM05";"     346";"     174";"     172";"   22217";"   11038";"   11179";"   22217";"   22217";"   20265";"       0";"       0";"       0";"       0";"       0";"       0"
"2618";"A043593";"2019MM06";"     330";"     164";"     166";"   20981";"   10541";"   10440";"   20981";"   20981";"   19349";"       0";"       0";"       0";"       0";"       0";"       0"
"2619";"A043593";"2019KW02";"     967";"     484";"     483";"   56820";"   27496";"   29324";"   56820";"   56707";"   51484";"     113";"     113";"       0";"       0";"       0";"       0"
"2620";"A043593";"2019MM07";"     281";"     138";"     143";"   19813";"    9391";"   10422";"   19813";"   19813";"   18438";"       0";"       0";"       0";"       0";"       0";"       0"
"2621";"A043593";"2019MM08";"     260";"     132";"     128";"   21459";"   10970";"   10489";"   21459";"   21459";"   19741";"       0";"       0";"       0";"       0";"       0";"       0"
"2622";"A043593";"2019MM09";"     409";"     203";"     206";"   20756";"   10376";"   10380";"   20756";"   20756";"   18876";"       0";"       0";"       0";"       0";"       0";"       0"
"2623";"A043593";"2019KW03";"     950";"     473";"     477";"   62028";"   30737";"   31291";"   62028";"   62028";"   57055";"       0";"       0";"       0";"       0";"       0";"       0"
"2624";"A043593";"2019MM10";"     376";"     187";"     189";"   16210";"    8726";"    7484";"   16210";"   16210";"   14524";"       0";"       0";"       0";"       0";"       0";"       0"
"2625";"A043593";"2019MM11";"     280";"     139";"     141";"    7341";"    3593";"    3748";"    7341";"    7341";"    7341";"       0";"       0";"       0";"       0";"       0";"       0"
"2626";"A043593";"2019MM12";"     219";"     111";"     108";"    7067";"    3514";"    3553";"    7067";"    7067";"    7067";"       0";"       0";"       0";"       0";"       0";"       0"
"2627";"A043593";"2019KW04";"     875";"     437";"     438";"   30618";"   15833";"   14785";"   30618";"   30618";"   28932";"       0";"       0";"       0";"       0";"       0";"       0"
"2628";"A043593";"2019JJ00";"    3390";"    1690";"    1700";"  176022";"   87559";"   88463";"  176022";"  175782";"  163900";"     240";"     240";"       0";"       0";"       0";"       0"
"2629";"A043593";"2020MM01";"     210";"     104";"     106";"    5290";"    2612";"    2678";"    5290";"    5290";"    5290";"       0";"       0";"       0";"       0";"       0";"       0"
"2630";"A043593";"2020MM02";"     164";"      82";"      82";"    4587";"    2292";"    2295";"    4587";"    4587";"    4587";"       0";"       0";"       0";"       0";"       0";"       0"
"2631";"A043593";"2020MM03";"      30";"      14";"      16";"    1999";"    1201";"     798";"    1999";"    1999";"    1999";"       0";"       0";"       0";"       0";"       0";"       0"
"2632";"A043593";"2020KW01";"     404";"     200";"     204";"   11876";"    6105";"    5771";"   11876";"   11876";"   11876";"       0";"       0";"       0";"       0";"       0";"       0"
"2633";"A043593";"2020MM04";"       5";"       3";"       2";"       0";"       0";"       0";"       0";"       0";"       0";"       0";"       0";"       0";"       0";"       0";"       0"
"2634";"A043593";"2020MM05";"       7";"       3";"       4";"      47";"      22";"      25";"      47";"      47";"      47";"       0";"       0";"       0";"       0";"       0";"       0"
"2635";"A043593";"2020MM06";"       6";"       5";"       1";"       0";"       0";"       0";"       0";"       0";"       0";"       0";"       0";"       0";"       0";"       0";"       0"
"2636";"A043593";"2020KW02";"      18";"      11";"       7";"      47";"      22";"      25";"      47";"      47";"      47";"       0";"       0";"       0";"       0";"       0";"       0"
"2637";"A043593";"2020MM07";"      54";"      28";"      26";"    2723";"    1081";"    1642";"    2723";"    2723";"    2723";"       0";"       0";"       0";"       0";"       0";"       0"
"2638";"A043593";"2020MM08";"      51";"      26";"      25";"    2231";"    1310";"     921";"    2231";"    2231";"    2231";"       0";"       0";"       0";"       0";"       0";"       0"
"2639";"A043593";"2020MM09";"      30";"      14";"      16";"     589";"     368";"     221";"     589";"     589";"     589";"       0";"       0";"       0";"       0";"       0";"       0"
"2640";"A043593";"2020KW03";"     135";"      68";"      67";"    5543";"    2759";"    2784";"    5543";"    5543";"    5543";"       0";"       0";"       0";"       0";"       0";"       0"
"2641";"A043593";"2020MM10";"      23";"      17";"       6";"      62";"      31";"      31";"      62";"      62";"      62";"       0";"       0";"       0";"       0";"       0";"       0"
"2642";"A043593";"2020MM11";"      22";"      11";"      11";"       0";"       0";"       0";"       0";"       0";"       0";"       0";"       0";"       0";"       0";"       0";"       0"
"2643";"A043593";"2020MM12";"      10";"       4";"       6";"       0";"       0";"       0";"       0";"       0";"       0";"       0";"       0";"       0";"       0";"       0";"       0"
"2644";"A043593";"2020KW04";"      55";"      32";"      23";"      62";"      31";"      31";"      62";"      62";"      62";"       0";"       0";"       0";"       0";"       0";"       0"
"2645";"A043593";"2020JJ00";"     612";"     311";"     301";"   17528";"    8917";"    8611";"   17528";"   17528";"   17528";"       0";"       0";"       0";"       0";"       0";"       0"
"2646";"A043593";"2021MM01";"      20";"      14";"       6";"       0";"       0";"       0";"       0";"       0";"       0";"       0";"       0";"       0";"       0";"       0";"       0"
"2647";"A043593";"2021MM02";"      23";"       8";"      15";"       0";"       0";"       0";"       0";"       0";"       0";"       0";"       0";"       0";"       0";"       0";"       0"
"2648";"A043593";"2021MM03";"      40";"      19";"      21";"       0";"       0";"       0";"       0";"       0";"       0";"       0";"       0";"       0";"       0";"       0";"       0"
"2649";"A043593";"2021KW01";"      83";"      41";"      42";"       0";"       0";"       0";"       0";"       0";"       0";"       0";"       0";"       0";"       0";"       0";"       0"
"2650";"A043593";"2021MM04";"      40";"      20";"      20";"       0";"       0";"       0";"       0";"       0";"       0";"       0";"       0";"       0";"       0";"       0";"       0"
"2651";"A043593";"2021MM05";"      27";"      10";"      17";"       0";"       0";"       0";"       0";"       0";"       0";"       0";"       0";"       0";"       0";"       0";"       0"
"2652";"A043593";"2021MM06";"      39";"      20";"      19";"     694";"     351";"     343";"     694";"     694";"     694";"       0";"       0";"       0";"       0";"       0";"       0"
"2653";"A043593";"2021KW02";"     106";"      50";"      56";"     694";"     351";"     343";"     694";"     694";"     694";"       0";"       0";"       0";"       0";"       0";"       0"
"2654";"A043593";"2021MM07";"     101";"      52";"      49";"    4119";"    1626";"    2493";"    4119";"    4119";"    4079";"       0";"       0";"       0";"       0";"       0";"       0"
"2655";"A043593";"2021MM08";"      74";"      34";"      40";"    4475";"    2002";"    2473";"    4475";"    4475";"    4475";"       0";"       0";"       0";"       0";"       0";"       0"
"2656";"A043593";"2021MM09";"      98";"      48";"      50";"    6212";"    3185";"    3027";"    6212";"    6212";"    6038";"       0";"       0";"       0";"       0";"       0";"       0"
"2657";"A043593";"2021KW03";"     273";"     134";"     139";"   14806";"    6813";"    7993";"   14806";"   14806";"   14592";"       0";"       0";"       0";"       0";"       0";"       0"
"2658";"A043593";"2021MM10";"      85";"      41";"      44";"    4794";"    2557";"    2237";"    4794";"    4794";"    4794";"       0";"       0";"       0";"       0";"       0";"       0"
"2659";"A043593";"2021MM11";"      68";"      33";"      35";"    3455";"    1713";"    1742";"    3455";"    3455";"    3455";"       0";"       0";"       0";"       0";"       0";"       0"
"2660";"A043593";"2021MM12";"      59";"      29";"      30";"    3511";"    1692";"    1819";"    3511";"    3511";"    3511";"       0";"       0";"       0";"       0";"       0";"       0"
"2661";"A043593";"2021KW04";"     212";"     103";"     109";"   11760";"    5962";"    5798";"   11760";"   11760";"   11760";"       0";"       0";"       0";"       0";"       0";"       0"
"2662";"A043593";"2021JJ00";"     674";"     328";"     346";"   27260";"   13126";"   14134";"   27260";"   27260";"   27046";"       0";"       0";"       0";"       0";"       0";"       0"
"2663";"A043593";"2022MM01";"      75";"      37";"      38";"    3666";"    1772";"    1894";"    3666";"    3666";"    3666";"       0";"       0";"       0";"       0";"       0";"       0"
"2664";"A043593";"2022MM02";"      79";"      37";"      42";"    3436";"    1607";"    1829";"    3436";"    3436";"    3436";"       0";"       0";"       0";"       0";"       0";"       0"
"2665";"A043593";"2022MM03";"      63";"      30";"      33";"    3306";"    1723";"    1583";"    3306";"    3306";"    3306";"       0";"       0";"       0";"       0";"       0";"       0"
"2666";"A043593";"2022KW01";"     217";"     104";"     113";"   10408";"    5102";"    5306";"   10408";"   10408";"   10408";"       0";"       0";"       0";"       0";"       0";"       0"
"2667";"A043593";"2022MM04";"      62";"      32";"      30";"    5010";"    2130";"    2880";"    5010";"    5010";"    4165";"       0";"       0";"       0";"       0";"       0";"       0"
"2668";"A043593";"2022MM05";"     120";"      57";"      63";"    8746";"    4376";"    4370";"    8746";"    8746";"    5837";"       0";"       0";"       0";"       0";"       0";"       0"
"2669";"A043593";"2022MM06";"     148";"      78";"      70";"    9400";"    4597";"    4803";"    9400";"    9400";"    6865";"       0";"       0";"       0";"       0";"       0";"       0"
"2670";"A043593";"2022KW02";"     330";"     167";"     163";"   23156";"   11103";"   12053";"   23156";"   23156";"   16867";"       0";"       0";"       0";"       0";"       0";"       0"
"2671";"A043593";"2022MM07";"     132";"      67";"      65";"   11314";"    5257";"    6057";"   11314";"   11314";"    7696";"       0";"       0";"       0";"       0";"       0";"       0"
"2672";"A043593";"2022MM08";"     135";"      65";"      70";"   13390";"    6840";"    6550";"   13390";"   13390";"    8313";"       0";"       0";"       0";"       0";"       0";"       0"
"2673";"A043593";"2022MM09";"     129";"      66";"      63";"   12223";"    5898";"    6325";"   12223";"   12223";"    8141";"       0";"       0";"       0";"       0";"       0";"       0"
"2674";"A043593";"2022KW03";"     396";"     198";"     198";"   36927";"   17995";"   18932";"   36927";"   36927";"   24150";"       0";"       0";"       0";"       0";"       0";"       0"
"2675";"A043593";"2022MM10";"     112";"      54";"      58";"    9732";"    5547";"    4185";"    9732";"    9512";"    5307";"     220";"       0";"     110";"     110";"       0";"       0"
"2676";"A043593";"2022MM11";"      69";"      38";"      31";"    3515";"    1726";"    1789";"    3515";"    2825";"    2734";"     690";"       0";"     690";"     690";"       0";"       0"
"2677";"A043593";"2022MM12";"      69";"      36";"      33";"    3467";"    1741";"    1726";"    3467";"    3467";"    3313";"       0";"       0";"       0";"       0";"       0";"       0"
"2678";"A043593";"2022KW04";"     250";"     128";"     122";"   16714";"    9014";"    7700";"   16714";"   15804";"   11354";"     910";"       0";"     800";"     800";"       0";"       0"
"2679";"A043593";"2022JJ00";"    1193";"     597";"     596";"   87205";"   43214";"   43991";"   87205";"   86295";"   62779";"     910";"       0";"     800";"     800";"       0";"       0"
"2680";"A043593";"2023MM01";"      64";"      31";"      33";"    3781";"    1848";"    1933";"    3781";"    3781";"    3662";"       0";"       0";"       0";"       0";"       0";"       0"
"2681";"A043593";"2023MM02";"      67";"      34";"      33";"    3501";"    1756";"    1745";"    3501";"    3501";"    3391";"       0";"       0";"       0";"       0";"       0";"       0"
"2682";"A043593";"2023MM03";"      68";"      35";"      33";"    3771";"    1996";"    1775";"    3771";"    3771";"    3671";"       0";"       0";"       0";"       0";"       0";"       0"
"2683";"A043593";"2023KW01";"     199";"     100";"      99";"   11053";"    5600";"    5453";"   11053";"   11053";"   10724";"       0";"       0";"       0";"       0";"       0";"       0"
"2684";"A043593";"2023MM04";"      61";"      30";"      31";"    5532";"    2249";"    3283";"    5532";"    5291";"    2996";"     241";"     241";"       0";"       0";"       0";"       0"
"2685";"A043593";"2023MM05";"     126";"      56";"      70";"   12283";"    6079";"    6204";"   12283";"   12141";"    6605";"     142";"       0";"       0";"       0";"       0";"       0"
"2686";"A043593";"2023MM06";"     126";"      64";"      62";"   10831";"    5568";"    5263";"   10831";"   10831";"    6848";"       0";"       0";"       0";"       0";"       0";"       0"
"2687";"A043593";"2023KW02";"     313";"     150";"     163";"   28646";"   13896";"   14750";"   28646";"   28263";"   16449";"     383";"     241";"       0";"       0";"       0";"       0"
"2688";"A043593";"2023MM07";"     126";"      62";"      64";"   12466";"    5177";"    7289";"   12466";"   12466";"    6915";"       0";"       0";"       0";"       0";"       0";"       0"
"2689";"A043593";"2023MM08";"     157";"      73";"      84";"   23618";"   12088";"   11530";"   23618";"   23618";"   12385";"       0";"       0";"       0";"       0";"       0";"       0"
"2690";"A043593";"2023MM09";"     122";"      59";"      63";"   14170";"    7591";"    6579";"   14170";"   14170";"    9448";"       0";"       0";"       0";"       0";"       0";"       0"
"2691";"A043593";"2023KW03";"     405";"     194";"     211";"   50254";"   24856";"   25398";"   50254";"   50254";"   28748";"       0";"       0";"       0";"       0";"       0";"       0"
"2692";"A043593";"2023MM10";"     119";"      56";"      63";"   11470";"    6352";"    5118";"   11470";"   11470";"    7048";"       0";"       0";"       0";"       0";"       0";"       0"
"2693";"A043593";"2023MM11";"      67";"      32";"      35";"    3073";"    1428";"    1645";"    3073";"    2964";"    2795";"     109";"       0";"       0";"       0";"       0";"       0"
"2694";"A043593";"2023MM12";"      78";"      43";"      35";"    4039";"    1913";"    2126";"    4039";"    4039";"    3947";"       0";"       0";"       0";"       0";"       0";"       0"
"2695";"A043593";"2023KW04";"     264";"     131";"     133";"   18582";"    9693";"    8889";"   18582";"   18473";"   13790";"     109";"       0";"       0";"       0";"       0";"       0"
"2696";"A043593";"2023JJ00";"    1181";"     575";"     606";"  108535";"   54045";"   54490";"  108535";"  108043";"   69711";"     492";"     241";"       0";"       0";"       0";"       0"
"2697";"A043593";"2024MM01";"      76";"      36";"      40";"    4356";"    2492";"    1864";"    4356";"    4356";"    4356";"       0";"       0";"       0";"       0";"       0";"       0"
"2698";"A043593";"2024MM02";"      68";"      35";"      33";"    3786";"    1972";"    1814";"    3786";"    3786";"    3764";"       0";"       0";"       0";"       0";"       0";"       0"
"2699";"A043593";"2024MM03";"      70";"      36";"      34";"    3581";"    1843";"    1738";"    3581";"    3581";"    3555";"       0";"       0";"       0";"       0";"       0";"       0"
"2700";"A043593";"2024KW01";"     214";"     107";"     107";"   11723";"    6307";"    5416";"   11723";"   11723";"   11675";"       0";"       0";"       0";"       0";"       0";"       0"
"2701";"A043593";"2024MM04";"      66";"      35";"      31";"    6335";"    2596";"    3739";"    6335";"    6335";"    4315";"       0";"       0";"       0";"       0";"       0";"       0"
"2702";"A043593";"2024MM05";"     119";"      54";"      65";"   11650";"    5873";"    5777";"   11650";"   11650";"    6829";"       0";"       0";"       0";"       0";"       0";"       0"
"2703";"A043593";"2024MM06";"     125";"      60";"      65";"   10634";"    5555";"    5079";"   10634";"   10634";"    6624";"       0";"       0";"       0";"       0";"       0";"       0"
"2704";"A043593";"2024KW02";"     310";"     149";"     161";"   28619";"   14024";"   14595";"   28619";"   28619";"   17768";"       0";"       0";"       0";"       0";"       0";"       0"
"2705";"A043593";"2024MM07";"     129";"      66";"      63";"    9608";"    3937";"    5671";"    9608";"    9608";"    7926";"       0";"       0";"       0";"       0";"       0";"       0"
"2706";"A043593";"2024MM08";"     161";"      78";"      83";"   20973";"   10774";"   10199";"   20973";"   20973";"   15034";"       0";"       0";"       0";"       0";"       0";"       0"
"2707";"A043593";"2024MM09";"     119";"      61";"      58";"   13364";"    6652";"    6712";"   13364";"   13364";"    9397";"       0";"       0";"       0";"       0";"       0";"       0"
"2708";"A043593";"2024KW03";"     409";"     205";"     204";"   43945";"   21363";"   22582";"   43945";"   43945";"   32357";"       0";"       0";"       0";"       0";"       0";"       0"
"2709";"A043593";"2024MM10";"     107";"      54";"      53";"   11344";"    6118";"    5226";"   11344";"   11344";"    6320";"       0";"       0";"       0";"       0";"       0";"       0"
"2710";"A043593";"2024MM11";"      59";"      29";"      30";"    3958";"    2270";"    1688";"    3958";"    3958";"    3435";"       0";"       0";"       0";"       0";"       0";"       0"
"2711";"A043593";"2024MM12";"      70";"      34";"      36";"    4151";"    1804";"    2347";"    4151";"    3236";"    3236";"     915";"       0";"       0";"       0";"       0";"       0"
"2712";"A043593";"2024KW04";"     236";"     117";"     119";"   19453";"   10192";"    9261";"   19453";"   18538";"   12991";"     915";"       0";"       0";"       0";"       0";"       0"
"2713";"A043593";"2024JJ00";"    1169";"     578";"     591";"  103740";"   51886";"   51854";"  103740";"  102825";"   74791";"     915";"       0";"       0";"       0";"       0";"       0"
"2714";"A043593";"2025MM01";"      71";"      36";"      35";"    4060";"    2199";"    1861";"    4060";"    3683";"    3683";"     377";"       0";"       0";"       0";"       0";"       0"
"2715";"A043593";"2025MM02";"      67";"      33";"      34";"    3772";"    1935";"    1837";"    3772";"    3772";"    3772";"       0";"       0";"       0";"       0";"       0";"       0"
"2716";"A043593";"2025MM03";"      63";"      31";"      32";"    3695";"    1941";"    1754";"    3695";"    3695";"    3695";"       0";"       0";"       0";"       0";"       0";"       0"
"2717";"A043593";"2025KW01";"     201";"     100";"     101";"   11527";"    6075";"    5452";"   11527";"   11150";"   11150";"     377";"       0";"       0";"       0";"       0";"       0"
"2718";"A043593";"2025MM04";"      66";"      31";"      35";"    6174";"    2461";"    3713";"    6174";"    6174";"    3669";"       0";"       0";"       0";"       0";"       0";"       0"
"2719";"A043593";"2025MM05";"     124";"      60";"      64";"   12766";"    6280";"    6486";"   12766";"   12766";"    6833";"       0";"       0";"       0";"       0";"       0";"       0"
"2720";"A043593";"2025MM06";"     151";"      76";"      75";"   11247";"    5888";"    5359";"   11247";"   11247";"    7734";"       0";"       0";"       0";"       0";"       0";"       0"
"2721";"A043593";"2025KW02";"     341";"     167";"     174";"   30187";"   14629";"   15558";"   30187";"   30187";"   18236";"       0";"       0";"       0";"       0";"       0";"       0"
"2722";"A043593";"2025MM07";"     144";"      72";"      72";"   15033";"    6598";"    8435";"   15033";"   15033";"   11099";"       0";"       0";"       0";"       0";"       0";"       0"
"2723";"A043593";"2025MM08";"     151";"      73";"      78";"   18305";"    9801";"    8504";"   18305";"   18305";"   13713";"       0";"       0";"       0";"       0";"       0";"       0"
